от тюмени до ханты мансийска сколько километров,676 километров на машине. Это путь от Тюмени до Ханты-Мансийска.,от ханты мансийска до сургута сколько километров на машине	search.geo.navi.distance
не мешай,Хорошо.,уральская сто двадцать девять	search.geo.address.general
город александров свято успенский женский монастырь поехали	search.geo.navi.route_general
российский проспект шестнадцать,Взгляните.,магазин полушка	search.geo.org.general
алиса давай мне навигатор быстрее	action.app.maps
карла маркса семь,Показываю варианты.,улица карла маркса семь краснодар	search.geo.address.general
архангельская новая таволжанка,Взгляните.,советская тридцать	search.geo.address.general
расстояние от йошкар олы до шеллака,Путь от Йошкар-Олы до "Shellak12" по адресу улица Строителей 32А займет 12 минут на автомобиле или 29 минут на общественном транспорте или 56 минут пешком.,расстояние от йошкар олы до шой булак	search.geo.navi.distance
нормально,Замечательно!,Надолго пробка	search.geo.navi.traffic_general
азимут вологда,Показываю варианты.,азимут на ленинградской вологда	search.geo.org.general
улица столетова,Показываю варианты.,новочеремушкинская тридцать четыре корпус один	search.geo.address.general
город ялта,Показываю варианты.,город ялта алупкинское шоссе тридцать четыре е маршрут	search.geo.navi.route_general
алиса маршрут до грибановки,В путь! Едем до "Грибановка".,алиса маршрут до грибановки	search.geo.navi.route_general
санобработку на бердском шоссе,По адресу Бердск\, улица Ленина 89/15 есть "Магистраль". Работает с 9 утра до 6 вечера. Сейчас закрыто.,ооо технарь диагностики на бердском шоссе	search.geo.org.general
красноярск авторазбор тойота корона бочка,По адресу улица Мусоргского 10АС1 есть "Toyota". Сейчас закрыто.,авторазборка тойота корона красноярск	search.geo.org.general
магазин столов на пушкина,Как насчет "Стол НСК"\, улица Галущака 3? Работает с 10 утра до 5 вечера. Сейчас открыто.,столы на пушкина	search.geo.org.general
средняя ахтуба,Средняя Ахтуба — Посёлок городского типа\, районный центр Среднеахтубинского района Волгоградской области. Население - 14477 чел.,как доехать до средней ахтубы с волгограда	search.geo.navi.route_general
ттк город рязань личный кабинет,Сначала поискала приложения\, потом сайты — нет\, ничего не нашлось. Но вы не переживайте\, поищем что-нибудь другое.,компания ттк город рязань	search.geo.org.general
амундсена шестьдесят три	search.geo.address.general
ресторан себастия серпухов,Может "Себастия" по адресу улица Чехова 17? Работает с 12 часов дня до 11 вечера. Сейчас открыто.,ферма тульская один	search.geo.org.general
чечерский проезд сто двадцать четыре корпус два,В путь! Едем домой.,чечерский проезд сто двадцать четыре корпус два	search.geo.address.general
момент на хуй в москве,Открываю поиск [ Открывается поиск по запросу <момент на хуй в москве> ],какая дорожная обстановка в данный момент в москве	search.geo.navi.traffic_general
алиса сколько баллов затруднения дороги в кемерово,В Кемерове — 3 балла\, местами затруднения.,а в каких местах затруднения	search.geo.navi.traffic_general
монетка город стерлитамак,Может "Монетка"\, улица Мира 1? Работает с 9 утра до 11 вечера. Сейчас открыто.,а где ближе есть монетка	search.geo.org.general
второй нагатинский проезд	search.geo.address.general
сорок лет победы сто пятьдесят восемь	search.geo.address.general
таганская шесть	search.geo.address.general
восьмое марта двести двенадцать,Взгляните.,восьмое марта двести двенадцать	search.geo.address.general
макдональдс на смоленской адрес,По адресу улица Арбат 52\, стр. 1 есть "Макдоналдс". Работает с 6:30 утра до полуночи. Сейчас открыто.,адрес макдональдса на смоленке	search.geo.org.general
шестака двадцать	search.geo.address.general
сто взлет город омск,Давайте поищем [ Открывается поиск по запросу <100 взлет город омск> ],техцентр взлет город омск	search.geo.org.general
сколько километров из казани до зеленодольска	search.geo.navi.distance
школа мбоу сош номер два александров два александра,По адресу Александров\, улица Ческа-Липа 5 есть "Гимназия № 2". Работает с 8 утра до 2 часов дня. Сейчас закрыто.,школа мбоу сош номер два александров гай саратовская область	search.geo.org.general
совкомбанк варшавское	search.geo.org.general
завтра погода на сургуте,Завтра в Сургуте от -10 до -13\, снег.,алиса где магазин монетка	search.geo.org.general
библиотека в новосибирске г п н т б саран	search.geo.org.general
алиса детский мир в курске,Могу предложить "Детский мир"\, Курск\, Студенческая улица 1. Работает с 10 утра до 10 вечера. Сейчас открыто.,Давай дальше	search.geo.org.general
заправка,Внимание на карту.,ближайшая заправка шелл	search.geo.org.general
кафе которое находится недалеко от моего местоположения,Я знаю\, что по адресу улица Яна Чечота 7 есть "Dolce". Работает с 10 утра до 11 вечера. Сейчас открыто.,Ещё	search.geo.org.general
малая ленинградская шестьдесят четыре а	search.geo.address.general
искровский проспект	search.geo.address.general
южнопортовый проезд десять,Взгляните.,второй южнопортовый проезд десять	search.geo.address.general
увд котельники	search.geo.org.general
пока,До встречи.,построить маршрут пешком город оленегорск от парковой шесть до жд вокзала	search.geo.navi.route_general
нахабино,Московская область\, городской округ Красногорск\, рабочий посёлок Нахабино — найдено на картах.,навигатор до нахабино	action.app.maps
малая ивановская один	search.geo.address.general
улица славная тридцать два	search.geo.address.general
братиславская дом тринадцать	search.geo.address.general
посольство украины в москве	search.geo.org.general
артюхиной шесть а	search.geo.address.general
алиса покажи мне всеволожск все магазины одежды,Могу предложить "Магазин одежды" по адресу Невская улица 13. Работает с 10 утра до 9 вечера. Сейчас открыто.,алиса магазин одежды вся вода с кем	search.geo.org.general
магазин аулет адреса,Я знаю\, что по адресу улица Ленина 2 есть "Adidas". Работает с 10 утра до 10 вечера. Сейчас открыто.,Ещё вариант	search.geo.org.general
большой головин переулок	search.geo.address.general
проложи маршрут до бориса ой,Дорога займет 1 час 29 минут на машине или 1 час 25 минут на транспорте. Это путь до адреса улица Бориса Галушкина.,проложи маршрут до алма атинской улице	search.geo.navi.route_general
индустриальная двадцать три	search.geo.address.general
аэропорт шереметьево гостиница	search.geo.org.general
глуховское баня	search.geo.org.general
тургеневское шоссе тридцать три	search.geo.address.general
рахманинова сто девять,Сейчас найду.,орбитальная семьдесят восемь	search.geo.address.general
лыжный переулок четыре корпус один	search.geo.address.general
автозапчасти кунцево,Взгляните.,автозапчасти кунцево на мкаде	search.geo.org.general
сто шестьдесят три,Это нормальный рост,поехали домой	search.geo.navi.route_general
магазин красное белое,Сейчас поищу.,магазин маяк	search.geo.org.general
москва улица производственная дом два корпус один	search.geo.address.general
пирогова четыре,Взгляните.,рыбное крымская дом семнадцать	search.geo.address.general
алиса,Здравствуйте.,найди мне пожалуйста нотариуса возле метро щелковская	search.geo.org.general
адрес неманская сорок пять минск,Нёманская улица 45 — найдено на картах.,открой карту	action.app.maps
алиса включи малышариков,Открываю поиск [ Открывается поиск по запросу <малышариков> ],алиса где найти в курске магазин стройматериалов	search.geo.org.general
сколько километров от нижнего ряда торгов,Куда?,сколько километров от нижнего ряда торгов	search.geo.navi.distance
капитанская четыре город холмск,Холмск\, Капитанская улица 4 — ответ есть на картах.,открой карту	action.app.maps
улица шубиных дом тридцать три,Показываю варианты.,пятнадцать проезд дом один	search.geo.address.general
галицкого один а	search.geo.address.general
индустриальная сто тридцать семь б	search.geo.address.general
магаданская улица дом один	search.geo.address.general
штрафплощадка,Взгляните.,штраф стоянка на элеваторной	search.geo.org.general
садово черногрязская шестнадцать москва,Внимание на карту.,новокуркинское шоссе пятьдесят один строение семь	search.geo.address.general
частное охранное предприятие в ростове хорошей зарплатой,Может\, подойдет "Охрана"\, Кировский проспект 40А? Работает с 9 утра до 6 вечера. Сейчас открыто.,а дальше	search.geo.org.general
пробки	search.geo.navi.traffic_general
улица горбунова	search.geo.address.general
город подольск улица орджоникидзе	search.geo.address.general
а в нижнекамске есть батутный центр,Я знаю\, что по адресу Нижнекамск\, улица 30 лет Победы 1 есть "Aura". Работает с 10 утра до 9 вечера. Сейчас открыто.,батутный центр в нижнекамске есть	search.geo.org.general
проспект ямашева восемьдесят девять	search.geo.address.general
служба оао сн,Смотрите\, что я нашла.,ооо спм росгвардии	search.geo.org.general
овчинникова одиннадцать	search.geo.address.general
кольчугино нефедовская семьдесят два	search.geo.address.general
бульвар рокоссовского дом шесть корпус один,Сейчас поищу.,бульвар рокоссовского дом шесть корпус один	search.geo.address.general
улица руставели	search.geo.address.general
норильская четыре а	search.geo.address.general
метро новослободская,Принято. Едем до "Новослободская" по адресу Кольцевая линия\, метро Новослободская.,райкин плаза	search.geo.org.general
волжск мира четырнадцать,Сейчас поищу.,байдукова восемьдесят восемь	search.geo.address.general
английский три корпус один кудрово	search.geo.address.general
совхозная тринадцать	search.geo.address.general
ремонт обуви в городе ступино	search.geo.org.general
ленинский проспект дом три,Сейчас найду.,магазин метро на одинцово	search.geo.org.general
алиса найди пожалуйста рядом со мной где то м видео,По адресу Ленинградское шоссе 1 есть "Евровидео". Работает с 10 утра до 8 вечера. Сейчас открыто.,еще варианты есть	search.geo.org.general
улица саморы машела номер один,Сейчас поищу.,город москва улица саморы машела один	search.geo.address.general
каспийская один,Показываю варианты.,миллерская дом тридцать три	search.geo.address.general
отели в адлере	search.geo.org.general
в каких заправках,Википедия вам в помощь,есть банкоматы московский кредитный банк	search.geo.org.general
пятьдесят,И что это значит?,мопра пятьдесят пять	search.geo.address.general
ярославский вокзал,Внимание на карту.,ярославский вокзал	search.geo.org.general
проложи маршрут до дома,И где находится дом?,станционная пять	search.geo.address.general
семафорная двести семьдесят один строение семь	search.geo.address.general
юбилейная сорок два красное белое	search.geo.org.general
деревня шарапово шестьдесят	search.geo.address.general
сибиряка один а	search.geo.address.general
алиса алиса сучка привет,Давайте сделаем вид\, что вы этого не говорили\, а я этого не слышала. И всё будет по-прежнему.,давай я тебя тоже люблю покажи мне в омске авторазборы	search.geo.org.general
якубова сорок шесть,Минск\, улица Якубова 46 — ответ есть на картах.,как пройти с нашего местоположения на якубова сорок шесть	search.geo.navi.route_general
режим работы администрации ленинского района,Вот что у меня есть.,администрация ленинского района городского округа саранск администрация	search.geo.org.general
ахматовская шесть пушкин	search.geo.address.general
больница ачигварское,По адресу село Орёл-Изумруд\, Банановая улица 144 есть "Ачигварское Озеро". Работает круглосуточно.,ачигварское больница	search.geo.org.general
блин,Что-то не так?,а сити парк какие магазины	search.geo.org.general
улица терешковой шесть,Сейчас найду.,школа номер тринадцать	search.geo.org.general
пожарный проезд дом три	search.geo.address.general
армейская девятнадцать	search.geo.address.general
улица новоселов дом шестьдесят,Показываю варианты.,торговый центр алина	search.geo.org.general
девятого мая пятьдесят восемь,Сейчас найду.,караульная сорок пять	search.geo.address.general
степная сто двадцать четыре	search.geo.address.general
костромская двадцать	search.geo.address.general
вятская сорок пять	search.geo.address.general
московская шестьдесят три,Внимание на карту.,восточно кругликовская сорок один	search.geo.address.general
отпариватели в киргу,Сейчас найдём [ Открывается поиск по запросу <отпариватели в киргу> ],магазин ноль пять ру в махачкале	search.geo.org.general
бани и сауны в городе абаза республики хакасия,Может "Общественная баня" по адресу улица Ленина 16Б?,еще какие варианты есть	search.geo.org.general
вишневая гора сайт,Вишневая Гора Парк-Отель гора-вишневая.рф,пробки саратова	search.geo.navi.traffic_general
усадьба отрада калужская область	search.geo.org.general
где находится милиция,По адресу улица Гая 4 есть "Октябрьский РОВД".,гродно ну конечно мне надо где а где гаи	search.geo.org.general
город подольск поселок быково улица академическая дом пять	search.geo.address.general
ближайшая круглосуточная аптека,По адресу Ставропольская улица 75/2 есть "Sos". Работает круглосуточно.,Ещё вариант	search.geo.org.general
невского один,Показываю варианты.,маршала василевского один	search.geo.address.general
улица революции тридцать пять	search.geo.address.general
найди парковку,Сейчас найдём.,поехали в офис яндекса	search.geo.navi.route_general
ураган урологическое отделение,К сожалению\, я ничего не нашла.,урология города асбест	search.geo.org.general
набережная канала грибоедова дом четыре тридцать четыре,Показываю варианты.,набережная канала грибоедова дом тридцать четыре	search.geo.address.general
расстояние от казани до самары,361 километр на машине. Это путь от Казани до Самары.,расстояние от кондрово калужской области до новокуйбышевска самарской области	search.geo.navi.distance
железнодорожная,Одну секунду... [ Открывается поиск по запросу <железнодорожная> ],железнодорожная больница город витебск	search.geo.org.general
ты где слушай алиса,К дому подхожу\, а что?,сколько от кемерово до салаира	search.geo.navi.distance
центральный жд вокзал туры,Дорога займет 17 часов 31 минуту на машине. Это путь до \"Центральный ВКЗ\" по адресу Киев\, Вокзальная площадь 1.,торунь центральный жд вокзал	search.geo.org.general
алиса можешь мне подсказать телефон мфц юго восточного округа,Как насчет \"Центр госуслуг района Некрасовка\"\, улица Маресьева 1? Работает с 8 утра до 8 вечера. Сейчас открыто.,центр гос услуг	search.geo.org.general
город урюпинск коммунальный переулок детский сад название	search.geo.org.general
сколько километров от уфы до челябинска,419 километров на машине. Это путь от Уфы до Челябинска.,сколько займет путь по времени от уфы до челябинска	search.geo.navi.distance
часы работы втб двадцать четыре на ленина,Как насчет \"ВТБ\"\, улица Ленина 46? Работает с 10 утра до 5 вечера. Сейчас закрыто.,по каким дням работает втб двадцать четыре на ленина в нижневартовске	search.geo.org.general
школа номер девять,Вот что я нашла.,школа номер девять	search.geo.org.general
можете сказать мне,А зачем вам это?,можете сказать телефон организации мои документы по адресу город куровское новинское шоссе	search.geo.org.general
лошадь ский дом культуры город минск вакансии на работу,Ищу в Яндексе [ Открывается поиск по запросу <лошадь ский дом культуры город минск вакансии на работу> ],город минск лошадь ский дом культуры	search.geo.org.general
адрес верификация кошелька яндекса в баку,Я знаю\, что по адресу Санкт-Петербург\, Пискарёвский проспект 2\, корп. 2Щ есть \"Яндекс.Деньги\". Работает с 9 утра до 8 вечера. Сейчас открыто.,алиса найди мне в баку	search.geo.org.general
алиса,Я здесь.,Где поужинать?	search.geo.org.general
как проехать жд кисловодск до медицинского колледжа,Маршрут займет 39 минут на машине. Это путь до \"Медколледж\" по адресу Кисловодск\, улица Кутузова 48Б.,проложить маршрут	search.geo.navi.route_general
легкий шаг город старый оскол,По адресу Белгородская область\, Старый Оскол\, микрорайон Восточный\, 47 есть \"Студия Красоты Cherry Старый Оскол\".,магазин легкий шаг город старый оскол	search.geo.org.general
юниструм банк в краснодаре,Смотрите\, что я нашла.,юникредит банк в краснодаре	search.geo.org.general
привет,Привет.,сдо на тридцатой северной подскажи	search.geo.org.general
как он авто аккумулятор,Ищу для вас ответ [ Открывается поиск по запросу <как он авто аккумулятор> ],режим работы автомагазинов аккумуляторный мир	search.geo.org.general
привет алиса,Привет-привет!,алиса хорошая глазная больница	search.geo.org.general
алиса ближайшая шаурма,По адресу Калининград\, 4-я Большая Окружная улица 35 есть \"Green Бистро\". Работает с 9 утра до 6 вечера. Сейчас открыто.,алиса ближайшая шаурма по адресу московский проспект двести семьдесят пять а	search.geo.org.general
фабрика сибирь в новосибирске ооо т в сибирь,Я знаю\, что по адресу Бетонная улица 6 есть \"Сибирь\". Работает с 9 утра до 17:30. Сейчас открыто.,ооо тф сибирь	search.geo.org.general
погода в белоруссии,Прямо сейчас я не могу уточнить погоду в белоруссии. Зато я могу рассказать вам о погоде в Минске. Сейчас в Минске -3\, пасмурно. Надеюсь\, вам это помогло.,как доехать деревня озеры	search.geo.navi.route_general
часы работы магазина эко море,По адресу Москва\, Соколово-Мещерская улица 25 есть \"Экоморье\". Работает с 9 утра до 10 вечера. Сейчас открыто.,магазин накамура в химках	search.geo.org.general
колпашево сургут расстояние,Путь займет 30 часов 17 минут на машине.,маршрут томск колпашево сургут расстояние	search.geo.navi.distance
кнопки на радиотелефоне панасоник,Найдётся всё! [ Открывается поиск по запросу <кнопки на радиотелефоне панасоник> ],первая экспедиционная компания ростов на дону адрес	search.geo.org.general
садовая фирма виктория	search.geo.org.general
в каких аптеках около станции беляево есть левитра,Какое место вы хотите найти?,около станции беляево	search.geo.org.general
сколько ехать от метро курского до метро первомайского	search.geo.navi.distance
алиса здравствуй подскажи пожалуйста как проехать на столбцы,Маршрут займет 2 часа 24 минуты на машине. Это путь до Столбцов.,до деревни за ямное	search.geo.navi.route_general
утес санаторий горный,Вот что у меня есть.,санаторий горный	search.geo.org.general
