anlık hava durumu		погода на сейчас
ayrıntılarıyla hava durumunu göster 		покажи подробнее погоду
ayrıntılı hava durumu, lütfen		подробная погода пожалуйста
ayrıntılı hava tahmini		подробный прогноз погоды
ayrıntılı tahmin		подробный прогноз
bana yarın için hava durumu lazım		погоду мне надо на завтра
ben neredeysem hava orada		погода там где я
bir gün için hava durumu		погода на один день
biri için hava durumu		погода на один
bizde hava güzel		погода у нас хороший
bizdeki hava		погода у нас
bize yarın için hava durumunu gösterin 		покажите нам погоду на завтра
bugün  ayrıntılı hava durumu		погода сегодня подробно
bugün hava durumu nasıl olacak söylesene		подскажи какая сегодня будет погода
bugün hava durumu nasıl olacak?		погода сегодня какая будет
bugün hava durumu nasıl olduğunu gösterin		покажите сегодня какая погода
bugün hava durumu nasıl?		погода сегодня какая
bugün hava durumunu söyle		погода сегодня скажи
bugün hava durumu		погода сегодня
bugün hava güzel		погода сегодня хороша
Bugün hava nasıl	"Bugün" (when) hava nasıl	Какая сегодня погода?
bugün hava nasıl olacağını  söylesene lütfen		подскажи пожалуйста какая сегодня погода
bugün için detaylı hava durumu		поточнее погода на сегодня
Bugün için hava durumu	"Bugün"(when) için hava durumu	Погода на сегодня
bugün için hava durumunu göster lütfen		покажи пожалуйста погоду на сегодня
bugün için hava durumunu göster 		покажи погоду на сегодня
bugünkü hava durumunu göster, lütfen		погоду покажи на сегодня
bugünkü hava durumunu söylesene		подскажи погоду на сегодня
bugünkü hava durumunu		погоду на сегодня
bugünkü hava durumu		погода на сегодня
bugün ve yarın için hava durumunu bize göster lütfen		пожалуйста покажи нам погода на сегодня и на завтра
bugün ve yarın için hava durumu		погода на сегодня и завтра
bugün yarın için hava durumu		погода на сегодня на завтра
bundan sonrası için hava durumu		погода на после
bütün gün için hava durumu		погода на целый день
detaylı hava durumu hakkında		подробно погоду
detaylı hava durumunu göster 		покажи погоду подробнее
dünden önceki gün hava nasıldı		позавчера какая погода будет
ekranda hava durumunu göstermek		показать погоду на экране
ekranda hava durumunu		погоду на экране
gpsten hava durumunu göster 		покажи погоду по gps
günlük hava durumunu söyle		погода на сегодня скажи
Haberler günlük hava durumu		погода на сегодня время
hadi hava durumunu		погоду давай
hadi konuşalım bu aralar hava nasıl		пообщаемся какая у нас нынче погода
hafta sonuna kadar hava durumunu		погоду до конца недели
haritada hava durumu		погода по карте
haritalı hava durumu		погода с картами
hava durumları		погоды
Hava durumu
hava durumu hakkına ayrıntılı olarak		поподробнее про погоду
hava durumu hakkında ayrıntılı bilgi verebilir misin, lütfen		подробнее можешь рассказать о погоде
hava durumu hakkında daha detaylı		подробнее о погоде
hava durumu hava durumu hava durumu		погода погода погода
hava durumu 	hava durumu 	погода в к
hava durumu hava durumu		погода погода
hava durumu ile yardım et		помоги мне с погодой
hava durumu kaç		погода сколько
hava durumu kötü		погода плохая
hava durumuna 		погоде
Hava durumu ne olacak	Какая будет погода?
hava durumu neşelendirmiyor		погода не радует
hava durumunu açıklayalım sen		погоду уточним ты не
hava durumunu açıklayalım		погода уточним
hava durumunu açıkla		погода уточни
hava durumunu açma		погоду в не открой
hava durumunu aç		погоду мне включи
hava durumunu ana ekrana		погоду на главный экран
hava durumunu ara		поищи пожалуйста погода то
hava durumunu gösterin 		покажите погоду
hava durumunu göstermek		показать погоду
hava durumunu hava durumunu söyle		погоду погоду скажи
hava durumunu izlemek		посмотреть погоду
hava durumunu, lütfen		погоду пожалуйста
hava durumunu söyle aptal		погоду предскажи дурень
hava durumunu söyle bugün için		погоду скажи на сегодня
hava durumunu söyle, lütfen		погоду скажи пожалуйста
hava durumunu söylesene bana		подскажи мне погоду
hava durumunu söylesene 		подскажи погоду
hava durumunu söyleyin lütfen		подскажите пожалуйста что за погода
hava durumunu söyle		погода расскажи
hava durumunu versene		погоду дай
hava durumunu yaz		погоду пиши
hava durumunu zaten biliyorum		погоду я знаю и так
hava durumunu		погоду
hava durumu örnek 		погода например
hava durumu söyle hava durumunu		погода скажи про погоду
hava durumu tahminini izlemek		посмотреть прогноз погоды
Havalar nasıl
Hava nasıl
hava tahmini, lütfen		погода пожалуйста
hava tahminini göster		покажи прогноз погода
hava tahminini söyle		погоду скажи
hava tahmini yanlış		погода не верна
havayı doğayı		погоду природу
hava		погодка
kilit ekranına hava durumunu		погоду на экран блокировки
konuma göre hava durumu		погода по местоположению
lütfen şu an hava nasıl		пожалуйста какая погода сейчас
neden yarın soğuk		почему завтра холодно
nerede orada hava durumu		погода там где что
Öbür gün için hava durumu	"Öbür gün"(when) için hava durumu	Погода на послезавтра
orada hava durumu		погода там
saat havası		погода часов
selam Alisa hava durumu		погода привет алиса
sokaktaki hava 		погода на улице
sonra hava nasıl olacak		потом какая будет погода
şu an hava durumu nasıl?		погода сейчас какая
şu an kaç derece olduğunu göster		покажи сколько сейчас градусов
tahmini göster		покажи прогноз
tam gün için hava durumunu göster bana		покажи мне погоду на весь день
tam hava durumunu 		полный прогноз погоды
tüm dünya için bugünkü hava durumu		погода на сегодня и на землю
tüm günlük hava durumu		погода на сегодня все
uan hava durumu		погода сейчас
Üç günlük hava durumu	"Üç günlük"(when) hava durumu	Погода на 3 дня
yakında hava durumu		погода рядом
Yandex hava durumları		погоды яндекса
Yandex hava durumu		погода яндекс
Yandex'ta hava durumu		погода на яндексе
yarından sonra hava durumu		послезавтра погода
yarından sonra hava nasıl olacak		послезавтра какая будет погода
yarından sonra hava nasıl		послезавтра какая погода
yarından sonraki hava durumu		погода послезавтра
yarından sonrası için hava durumunu söyle bana 		погода на послезавтра скажи мне
yarından sonrası için hava durumu 		погода на послезавтра
yarından sonra ve ondan sonra ve daha sonrası için hava durumu		погода на после после после после после послезавтра
yarın hava durumu nasıl olacağını ara lütfen		поищи пожалуйста какая будет завтра погода
Yarın hava durumu ne olacak	"Yarın" (when) hava durumu ne olacak
yarın hava durumu		погод.  Завтра
Yarın hava ne olacak	"Yarın" (when) hava ne olacak	Какая погода будет завтра?
yarın için ayrıntılı hava durumunu göster 		покажи подробнее погода на завтра
yarın için ayrıntılı hava durumu tahminini göster 		покажи подробный прогноз на завтра погода
yarın için ayrıntılı hava durumu		подробная погода на завтра
yarin için ayrıntılı hava tahmini		подробный прогноз погоды на завтра
yarın için hava durumu harita gösterin 		покажите карты погода на завтра
yarın için hava durumu lütfen		пожалуйста погоду на завтра
yarın için hava durumunu göster bana		покажи мне погоду на завтра
yarın için hava durumunu göster lütfen		покажи пожалуйста на завтра погоду
yarın için hava durumunu göster 		покажи погоду на завтра
yarın için hava durumunu lütfen söyleyin		пожалуйста скажите погоду на завтра
yarın için hava durumunu söylesene		погоду на завтра подскажи пожалуйста
yarın için hava durumunu söyle		погоду на завтра скажи
yarın için hava durumunu		погоду на завтра
Yarın için hava durumu	"Yarın"(when) için hava durumu	Погода на завтра
yarın için şehirdeki hava durumunu göstermek		показать погоду на завтра в городе
yarın ve ertesi gün için hava durumunu		погоду на завтра на послезавтра
