Gündüz hava ne olacak	"Gündüz" (day_part) hava ne olacak	Какая погода днем?
Şimdi hava nasıl	"Şimdi" (day_part) hava nasıl	Какая погода сейчас?
Şu an hava nasıl	"Şu an" (day_part) hava nasıl
İzmit için üç günlük hava durumu	"İzmit"(where) için "üç günlük"(when) hava durumu	погода в ижевске на три дня
İzmit ilçesi Kurtdere Köyü için  hava durumu	"İzmit ilçesi Kurtdere Köyü"(where) için  hava durumu	погода в ижевском районе село каменномостское
nehir için  hava durumu	"nehir"(where) için  hava durumu	погода в из реки
İskenderun için hava durumu	"İskenderun"(where) için hava durumu	погода в избербаше
İnegöl için hava durumu	"İnegöl"(where) için hava durumu	погода в изобильном
İsrail Ashqelon için hava durumu	"İsrail Ashqelon"(where) için hava durumu	погода в израиле ашкелон
İdil için hava durumu	"İdil"(where) için hava durumu	погода в иксе
İscehisar için hava durumu	"İscehisar"(where) için hava durumu	погода в иланске
İscehisar'da tüm gün için hava durumu	"İscehisar'da"(where) "tüm gün"(when) için hava durumu	погода в иланском на весь день
Ilgın için hava durumu	"Ilgın"(where) için hava durumu	погода в илецке
İçel için hava durumu	"İçel"(where) için hava durumu	погода в ильинско подомское
Isparta için hava durumu	"Isparta"(where) için hava durumu	погода в ильиче
Ordu ili Fatsa ilçesi İslambağ köyü için hava durumu	"Ordu ili Fatsa ilçesi İslambağ köyü"(where) için hava durumu	погода в имангулово оренбургская область октябрьский район
Hindistan için hava durumu	"Hindistan"(where) için hava durumu	погода в индии
İncirlik için hava durumu	"İncirlik"(where) için hava durumu	погода в инжавино
İnönü için hava durumu	"İnönü"(where) için hava durumu	погода в инзе
İmamoğlu için hava durumu	"İmamoğlu"(where) için hava durumu	погода в инзере
Iğdır için hava durumu	"Iğdır"(where) için hava durumu	погода в инте
Ürdün'de Kasım ayı için hava durumu	"Ürdün'de"(where) "Kasım ayı"(when) için hava durumu	погода в иордании в ноябре
İzmir için hava durumu	"İzmir"(where) için hava durumu	погода в иркутске
İzmir için hava durumu söylemek lazım	"İzmir"(where) için hava durumu söylemek lazım	погода в иркутске говорить надо
İzmir'de yarın için hava durumu	"İzmir'de"(where) "yarın"(when) için hava durumu	погода в иркутске завтра
İzmir için hava durumu	"İzmir"(where) için hava durumu	погода в иркутске на
İzmir'de Ağustos Eylül ayları için hava durumu	"İzmir'de"(where) "Ağustos"(when) "Eylül ayları"(when) için hava durumu	погода в иркутске на август сентябрь месяц
İzmir'de hafta sonu için hava durumu	"İzmir'de"(where) "hafta sonu"(when) için hava durumu	погода в иркутске на выходные
İzmir'de on Temmuz için hava durumu	"İzmir'de"(where) "on Temmuz"(when) için hava durumu	погода в иркутске на десятое июля
İzmir için on günlük hava durumu	"İzmir"(where) için "on günlük"(when) hava durumu	погода в иркутске на десять дней
İzmir'de yarın için hava durumu	"İzmir'de"(where) "yarın"(when) için hava durumu	погода в иркутске на завтра
İzmir'de bir Ağustos İki Bin On Yedi hava durumu	"İzmir'de"(where) "bir Ağustos İki Bin On Yedi"(when) hava durumu	погода в иркутске на первое августа две тысячи семнадцать
bugün için İzmir hava durumu	"bugün"(when) için "İzmir"(where) hava durumu	погода в иркутске на сегодня
İzmir'de gelecek hafta için hava durumu	"İzmir'de"(where) "gelecek hafta"(when) için hava durumu	погода в иркутске на следующую неделю
İzmir'de otuz bir Ağustos için hava durumu	"İzmir'de"(where) "otuz bir Ağustos"(when) için hava durumu	погода в иркутске на тридцать первое августа
İzmir'de bugün için hava durumu	"İzmir'de"(where) "bugün"(when) için hava durumu	погода в иркутске сегодня
İmişli için ayrıntılı hava durumu	"İmişli"(where) için ayrıntılı hava durumu	погода в искитиме подробная
İslamey için hava durumu	"İslamey"(where) için hava durumu	погода в исламей
İsmayıllı için hava durumu	"İsmayıllı"(where) için hava durumu	погода в исменцах
İspanya için hava durumu	"İspanya"(where) için hava durumu	погода в испании
İncirliova için hava durumu	"İncirliova"(where) için hava durumu	погода в истра
İncirliova için hava durumu	"İncirliova"(where) için hava durumu	погода в истре
İncirliova için aylık hava durumu	"İncirliova"(where) için "aylık"(when) hava durumu	погода в истре на месяц
İncirliova için haftalık hava durumu	"İncirliova"(where) için "haftalık"(when) hava durumu	погода в истре на неделю
İsfara için hava durumu	"İsfara"(where) için hava durumu	погода в исфаре
İtalya için hava durumu	"İtalya"(where) için hava durumu	погода в италии
İtalya Cenova şehrinin hava durumu	"İtalya Cenova şehrinin"(where) hava durumu	погода в италии город генуя
bugün için İtalya  hava durumu	"bugün"(when) için "İtalya"(where)  hava durumu	погода в италии на сегодня
İbradı için hava durumu	"İbradı"(where) için hava durumu	погода в ишимбае
İbradı için beş günlük hava durumu	"İbradı"(where) için "beş günlük"(when) hava durumu	погода в ишимбае на два дня
İbradı için üç günlük hava durumu	"İbradı"(where) için "üç günlük"(when) hava durumu	погода в ишимбае на три дня
İbradı için hava durumu	"İbradı"(where) için hava durumu	погода в ишиме
İbradı'da yarın için hava durumu	"İbradı'da"(where) "yarın"(when) için hava durumu	погода в ишиме на завтра
İbradı'da gelecek hafta için hava durumu	"İbradı'da"(where) "gelecek hafta"(when) için hava durumu	погода в ишиме на следующую неделю İ
Uşak'da Temmuz ayı için hava durumu	"Uşak'da"(where) "Temmuz ayı"(when) için hava durumu	погода в июле в уфе
Johannesburg için hava durumu	"Johannesburg"(where) için hava durumu	погода в йоханнесбурге
bugün için Yozgat hava durumu	"bugün"(when) için "Yozgat"(where) hava durumu	погода в йошкар ола на сегодня
Yozgat için hava durumu	"Yozgat"(where) için hava durumu	погода в йошкар оле
Yozgat'ta gelecek hafta için hava durumu	"Yozgat'ta"(where) "gelecek hafta"(when) için hava durumu	погода в йошкар оле на неделю
Yozgat'ta on beş Temmuz için hava durumu	"Yozgat'ta"(where) "on beş Temmuz"(when) için hava durumu	погода в йошкар оле на пятнадцатое июля
Yozgat'ta bugün için hava durumu	"Yozgat'ta"(where) "bugün"(when) için hava durumu	погода в йошкар оле на сегодня
Yozgat'ta şu an için hava durumu	"Yozgat'ta"(where) "şu an"(day_part) için hava durumu	погода в йошкар оле сейчас
Kaa-Khem için hava durumu	"Kaa-Khem"(where) için hava durumu	погода в каа хеме
Kastamonu için hava durumu	"Kastamonu"(where) için hava durumu	погода в кабанске
Kastamonu bölgesi için hava durumu	"Kastamonu"(where) bölgesi için hava durumu	погода в кабанском районе
Kaman için hava durumu	"Kaman"(where) için hava durumu	погода в кабардинке
Kaman Kırşehir ili için iki günlük hava durumu	"Kaman Kırşehir ili"(where) için "iki günlük"(when) hava durumu	погода в кабардинке краснодарский край на два дня
Kaman Kırşehir ili için hava durumu	"Kaman Kırşehir ili"(where) için hava durumu	погода в кабардинке краснодарского края
Kaman Kırşehir ili için haftalık hava durumu	"Kaman Kırşehir ili"(where) için "haftalık"(when) hava durumu	погода в кабардинке краснодарского края на неделю
Kaman'da on beş Temmuz için hava durumu	"Kaman'da"(where) "on beş Temmuz"(when) için hava durumu	погода в кабардинке на пятнадцатое июля
Kula'da yirmisinde hava durumu	"Kula'da"(where) "yirmisinde"(when) hava durumu	погода в кабырзе на двадцатое а
Kepez için hava durumu	"Kepez"(where) için hava durumu	погода в кавказской
Konaklı için hava durumu	"Konaklı"(where) için hava durumu	погода в кадоме
Kahramanmaraş için hava durumu	"Kahramanmaraş"(where) için hava durumu	погода в казани
Kahramanmaraş Ekinözü ilçesi için hava durumu	"Kahramanmaraş Ekinözü ilçesi"(where) için hava durumu	погода в казани кировский район
Kahramanmaraş için on günlük hava durumu	"Kahramanmaraş"(where) için "on günlük"(when) hava durumu	погода в казани на десять дней
Kahramanmaraş'ta yarın için hava durumu	"Kahramanmaraş'ta"(where) "yarın"(when) için hava durumu	погода в казани на завтра
Kazan’da bugün için hava durumu	"Kazan’da"(where) "bugün"(when) için hava durumu	погода в казани на сегодня
Kahramanmaraş için üç günlük hava durumu	"Kahramanmaraş"(where) için "üç günlük"(when) hava durumu	погода в казани на три дня
Kahramanmaraş'ta on altı Ağustos için hava durumu	"Kahramanmaraş'ta"(where) "on altı Ağustos"(when) için hava durumu	погода в казани на шестнадцатое августа
Kazan Kahramankazan için hava durumu	"Kazan Kahramankazan"(where) için hava durumu	погода в казанище нижнем казанище
Kazakistan için hava durumu	"Kazakistan"(where) için hava durumu	погода в казахстане
Kahire için hava durumu	"Kahire"(where) için hava durumu	погода в каире
Kurubaş köyü için hava durumu	"Kurubaş köyü"(where) için hava durumu	погода в какая погода в станице казанской
Kırıkkale için hava durumu	"Kırıkkale"(where) için hava durumu	погода в калаче на дону
Kırıkkale için hava durumu	"Kırıkkale"(where) için hava durumu	погода в калачинске
Karaman için hava durumu  	"Karaman"(where) için hava durumu  	погода в калининграде
Karaman için hava durumu	"Karaman"(where) için hava durumu	погода в калининграде
Karaman’da pazartesi için hava durumu 	"Karaman’da"(where) "pazartesi"(when) için hava durumu 	погода в калининграде в понедельник
Karaman Ayrancı ilçesi için hava durumu	"Karaman Ayrancı ilçesi"(where) için hava durumu	погода в калининграде московский район
Karaman için hafta sonu hava durumu	"Karaman"(where) için "hafta sonu"(when) hava durumu	погода в калининграде на выходные
Karaman'da yarın için hava durumu	"Karaman'da"(where) "yarın"(when) için hava durumu	погода в калининграде на завтра
Karaman için aylık hava durumu	"Karaman"(where) için "aylık"(when) hava durumu	погода в калининграде на месяц
Karaman'da Eylül ayı için hava durumu	"Karaman'da"(where) "Eylül ayı"(when) için hava durumu	погода в калининграде на сентябрь
Karaman'da saat on dört için hava durumu	"Karaman'da"(where) "saat on dört"(day_part) için hava durumu	погода в калининграде на четырнадцать часов
Karaman'da şu an için hava durumu	"Karaman'da"(where) "şu an"(day_part) için hava durumu	погода в калининграде сейчас
Karaman'da Eylül iki için hava durumu	"Karaman'da"(where) "Eylül iki"(when) için hava durumu	погода в калининграде сентябрь две
Karaman ili için hava durumu	"Karaman ili"(where) için hava durumu	погода в калининградской области
Sarıveliler Karaman ili için yarın için hava durumu	"Sarıveliler Karaman ili"(where) için "yarın"(when) için hava durumu	погода в калининградской области светлый на завтра
Kofçaz ilçesi için hava durumu	"Kofçaz ilçesi"(where) için hava durumu	погода в калининском районе
Kayabaşı Samsun ili için hava durumu	"Kayabaşı Samsun ili"(where) için hava durumu	погода в калиново свердловская область
Kayabaşı Samsun ili için hava durumu	"Kayabaşı Samsun ili"(where) için hava durumu	погода в калиново свердловской области
Ketenci için hava durumu	"Ketenci"(where) için hava durumu	погода в калманке
Kütahya için hava durumu	"Kütahya"(where) için hava durumu	погода в калуге
Kütahya için ay sonuna kadar hava durumu	"Kütahya"(where) için "ay sonuna kadar"(when) hava durumu	погода в калуге до конца месяца
Kütahya'da yarın için hava durumu	"Kütahya'da"(where) "yarın"(when) için hava durumu	погода в калуге завтра
Kütahya'da bugün akşam için hava durumu	"Kütahya'da"(where)"bugün"(when) "akşam"(day_part) için hava durumu	погода в калуге на вечер сегодня
Kütahya için iki günlük hava durumu		погода в калуге на два дня
Kütahya için on günlük hava durumu		погода в калуге на десять дней
Kütahya'da yarın için hava durumu		погода в калуге на завтра
Kütahya için haftalık hava durumu		погода в калуге на неделю
bugün için Kütahya hava durumu		погода в калуге на сегодня
Kütahya  için hava durumu beş		погода в калуге рт пять
bugün için Kütahya hava durumu		погода в калуге сегодня
Kütahya'da şu an için hava durumu		погода в калуге сейчас
Alisa lütfen Kütahya için hava durumunu söyler misin 		погода в калуге скажите пожалуйста алиса
Kütahya ili için hava durumu		погода в калужской области
Kütahya ili için üç günlük hava durumu		погода в калужской области на три дня
Kilis için hava durumu		погода в калязине
Kars için hava durumu		погода в каменке
bugün için Kars hava durumu		погода в каменке на сегодня
Kavak için hava durumu		погода в каменск уральске
Kavak'ta yirmi iki Temmuz için hava durumu		погода в каменск уральске на двадцать второе июля
Kavak için on dört günlük hava durumu		погода в каменск уральском на четырнадцать дней
Kırıkhan  için hava durumu		погода в каменск шахтинском
Kırıkhan için hava durumu		погода в каменске
Kırıkhan için haftalık hava durumu		погода в каменске на неделю
Kavak için hava durumu		погода в каменске уральске
Kavak  için haftalık hava durumu		погода в каменске уральске на неделю
Kavak  için gece hava durumu		погода в каменске уральске ночью
Kavak  için hava durumu		погода в каменске уральском
Kavak  yirmi yedi Ağustos için hava durumu		погода в каменске уральском двадцать седьмое августа
Yarın için Kavak ’ta hava durumu		погода в каменске уральском завтра
Kavak'ta  dokuz Ağustos iki bin on yedi için hava durumu		погода в каменске уральском на девятое августа две тысячи семнадцатого года
Yarın için Kavak'ta hava durumu		погода в каменске уральском на завтра
Kavak 'ta  on beş Temmuz için hava durumu		погода в каменске уральском на пятнадцатое июля
Kavak'ta on altı Temmuz için hava durumu		погода в каменске уральском на шестнадцатое июля
Kavak  Samsun ilinde on üç Temmuz için hava durumu		погода в каменске уральском свердловская область на тринадцатое июля
Bugün için Kavak ’ta hava durumu		погода в каменске уральском сегодня
Kırıkhan için hava durumu		погода в каменске шахтинском
Kırıkhan için hafta sonu hava durumu		погода в каменске шахтинском на выходные
Kırıkhan için haftalık hava durumu		погода в каменском на неделю
Kaymaklı için hava durumu		погода в камень
Kaymaklı için hava durumu		погода в камень рыболове
 Kuşadası için hava durumu		погода в камне на оби
 Kuşadası için yarınki hava durumu		погода в камне на оби на завтра
Kapaklı için hava durumu		погода в камских полянах
Karaada için hava durumu		погода в камчатке
Keşan'de on yedisinden otuz Temmuza kadar için hava durumu		погода в камышене семнадцатого по тридцатое июля
Keşan  için hava durumu		погода в камышине
Keşan  için yarınki hava durumu		погода в камышине завтра
Keşan  için yarınki hava durumu		погода в камышине на завтра
Bugün için Keşan  hava durumu		погода в камышине сегодня
Kozlu için hava durumu		погода в камышлове
Karapınar için haftalık hava durumu		погода в канаше на неделю
Kurtalan için hava durumu		погода в кандалакше
Karasu  için yarından sonraki hava durumu		погода в кандрах на послезавтра
Kula için hava durumu		погода в кандрыкуль
Kilimli için hava durumu		погода в каневской
Kozluk için hava durumu		погода в карабудахкенте
Korketeli ilçesi için hava durumu		погода в карагае гафурийский район
Kovancılar için hava durumu		погода в караганде
Kovancılar için hava durumu saat kaç hangi gün		погода в караганде сколько время какое число
Kulu için hava durumu		погода в каразее
Karaağaç için hava durumu		погода в караиделе
Kağızman için haftalık hava durumu		погода в карасук на нелелю
Kağızman için hava durumu		погода в карасуке
Kağızman için üç günlük hava durumu		погода в карасуке на три дня
Kızılcahamam için hava durumu		погода в карачаевске
Bugün için Kızılcahamam hava durumu		погода в карачеве на сегодня
Kızılcahamam için hava durumu		погода в карачи
Kadınhanı için hava durumu		погода в каргате
Bugün için Kadınhanı hava durumu		погода в каргате на сегодня
Kemer için hava durumu		погода в каргополе
Kemer için yarın ve yarından sonra hava durumu		погода в каргополе на завтра и на послезавтра
Kemer için hava durumu		погода в каргополь
Bugün Kemer için saatlik hava durumu		погода в каргополье на сегодня по часам
Elmacık Köyu Kemer ilçesi için hava durumu		погода в каргопольском районе деревня шевинская
Kırıklareli için hava durumu		погода в карелии
Vize Kırıklareli'nde yarın için hava durumu		погода в карелии коровникова на завтра
Karlsruhe için hava durumu		погода в карлсруэ
Kevenli için hava durumu		погода в кармаскалах
Kevenli için hava durumu		погода в кармаскалах козел
Korgan için hava durumu		погода в карталах
Kartali'de yarın için hava durumu		погода в карталах на завтра
Karşi için hava durumu		погода в карши
Kocaali için hava durumu		погода в каспийске
saat yedi de Kocaali için hava durumu		погода в каспийске семь часов
Kangal için hava durumu		погода в касумкенте
Kuzuculu için hava durumu		погода в катайске
Kulp için hava durumu		погода в качканаре
Karaburun İzmir bölgesinde yarın için hava durumu		погода в качуге иркутской области на завтра
Karadurun'da yarın için hava durumu		погода в качуге на завтра
Kalkandere Rize ili için hava durumu		погода в кашарах ростовская область
Kaşir için hava durumu		погода в кашире
Kaşir'da yarın için hava durumu		погода в кашире на завтра
Kınık  için hava durumu		погода в кашхатау
Kargıpınarı için hava durumu		погода в каякенте
Bugün ve yarın için Korgan ilçesinde hava durumu		погода в кваркенском районе на сегодня на завтра
Kumluca için hava durumu		погода в кедровом
Kemer için hava durumu		погода в кемер
Kemer için hava durumu		погода в кемере
Kemer için hava durumu		погода в кемерове
Kemer için hava durumu		погода в кемерово
Kemer için öğlen hava durumu		погода в кемерово днем
Kemer için iki haftalık hava durumu		погода в кемерово на две недели
Kemer'de yarın için hava durumu		погода в кемерово на завтра
Kemer için haftalık hava durumu		погода в кемерово на неделю
Kemeriçin üç günlük hava durumu		погода в кемерово на три дня
Kemer için gece hava durumu		погода в кемерово ночью
Kemer'de şu an için hava durumu		погода в кемерово сейчас
Kışla'da yarın için hava durumu		погода в кемле на завтра
Çanakkale için hava durumu		погода в керчи
Çanakkale'de yarın için hava durumu		погода в керчи на завтра
Köprübaşı ilçesi Trabzon ili için hava durumu		погода в кесовогорского района тверской области
Kulfallı  için hava durumu		погода в кибрай
Kuloğlu için hava durumu		погода в кижинге
Kabaoğlu için hava durumu		погода в кизиле
Kabaoğlu için hava durumu		погода в кизильском
Kargaköy için hava durumu		погода в кизилюрте
bugün için Kısalar’da hava durumu		погода в кизилюрте сегодня
Kısalar için hava durumu		погода в кизляре
Kısalar’da yarın için hava durumu		погода в кизляре на завтра
Kısalar’da için aylık hava durumu		погода в кизляре на месяц
Bugün için Kısalar hava durumu		погода в кизляре на сегодня
Bugün ve yarın için Kısalar’da hava durumu		погода в кимовске сегодня и завтра
Kuyulu için hava durumu		погода в кимрах
Kuyuluda yirmi sıfır sekiz için hava durumu		погода в кимрах на двадцатое ноль восьмое
Konya için hava durumu		погода в кингисеппе
Konya için haftalık hava durumu		погода в кингисеппе на неделю
Konya için uydu hava durumu		погода в кингисеппе со спутника
Kadriye için hava durumu		погода в кинеле
Kadriye için hava durumu		погода в кинеля
Kineshma için hava durumu		погода в кинешме
Kineshma için iki günlük hava durumu 		погода в кинешме на два дня
Kargaköy için sabah hava durumu		погода в кинешме утром
Sinema için hava durumu		погода в кино
Kırgızistan için hava durumu		погода в киргизистан
Kyrenia Kuzey Kıbrıs için hava durumu		погода в кирении на северном кипре
Kulfallı için iki haftalık hava durumu		погода в киржаче на две недели
Kayabağ için hava durumu		погода в киришах
Kayabağ'da yarın için hava durumu		погода в кириши на завтра
Kocaeli için hava durumu		погода в кирове
Kocaeli’nde pazar günü için hava durumu		погода в кирове воскресенье
Kocaeli'nde sekiz Ağustos için hava durumu		погода в кирове на восьмое августа
Kocaeli'nde yarın için hava durumu		погода в кирове на завтра
Cuma günü Kocaeli içi hava durumu		погода в кирове на пятницу
Kıranardı için hava durumu		погода в кировограде
Kocaeli için bir hava durumu		погода в кировске на один
Kocaeli ilçesi için hava durumu		погода в кировском районе
Kayseri için hava durumu		погода в кисловодске
Kayseri'de yirmi iki Ağustos için hava durumu		погода в кисловодске двадцать второго августа
Yarından sonra için Kayseri’de hava durumu		погода в кисловодске на послезавтра
Bugün için Kayseri’de hava durumu		погода в кисловодске сегодня
Kayseri'de beş Ağustos Cumartesi için hava durumu		погода в кисловодске субботу пятого августа
Çin'de yarın için hava durumu		погода в китае на завтра
Küçükbörüngüz için hava durumu		погода в кишиневе
Karakocalı'da yarın için hava durumu		погода в кишках на завтра
Kaş'ta  yarın için hava durumu		погода в києві на завтра
sınıftaki hava durumu		погода в классе
Keşefli için hava durumu		погода в клетне
Kızılcaşehir için hava durumu		погода в климовске
Kocaoğlanlı  için hava durumu		погода в клину
Kocaoğlanlı'da yarın için hava durumu		погода в клину на завтра
Kuzyaka için hava durumu		погода в клинцах
Karakocalı için hava durumu		погода в ключищах
Kalecik Ankara ili için hava durumu		погода в князево московская область
Fındıklı Rize ili  hava durumu		погода в ковалевке ростовская обувь
Keçiören için hava durumu		погода в ковдоре
Keçiören'de beş Ağustos için hava durumu		погода в ковдоре на пятое августа
Keçiören için hava durumu		погода в коврове
Keçiören'de yarın için hava durumu		погода в коврове завтра
Keçiören için yarınki hava durumu		погода в коврове на завтра
Keçiören'de bugün için hava durumu		погода в коврове сегодня
Kargıak için hava durumu		погода в когалыме
Kargıak için iki haftalık hava durumu		погода в когалыме на две недели
Konaklı için hava durumu		погода в козловке
Kağızman için hava durumu		погода в койгородке
Kazımkarabekir için hava durumu		погода в коккорево
Kaman için haftalık hava durumu		погода в кокошкино на неделю
Koktebel için hava durumu		погода в коктебеле
Koktebel için hava durumu		погода в коктебель
Kurucaşile için hava durumu 		погода в колодезном
Kemalpaşa için hava durumu		погода в колокша
Küre için hava durumu		погода в коломне
Küre için iki haftalık hava durumu		погода в коломне на две недели
lütfen Küre için hava durumunu söylermisin		погода в коломне скажи пожалуйста
Karakeçili'de yarın için hava durumu		погода в колпашево на завтра
Karakeçili'de bir Haziran ve bir Ağustos  için hava durumu		погода в колпашево на первого на первое июня августа
Keskin için hava durumu		погода в колпино
Kağızman için hava durumu		погода в колывани
Keles'te yarın için hava durumu		погода в комарово на завтра
ticarette hava durumu		погода в коммерции
Karacabey'de yarın için hava durumu		погода в коммунаре на завтра
Karacabey için hava durumu		погода в коммунарке
Kumlu için hava durumu		погода в комсомольске на амуре
Kumlu'da yarın için hava durumu		погода в комсомольске на амуре на завтра
Kumlu'da hava durumu		погода в комсомольске на амуре на сегодня
yarından sonra için Kumlu'da  hava durumu		погода в комсомольске на амуре послезавтра
Uzak Doğu Kumlu Hatay ili için hava durumu		погода в комсомольске на амуре хабаровского края дальнего востока
Kumlu'da tüm gün için hava durumu		погода в комсомольске на целый день
 Karaisalı için hava durumunu söyler misin Konakovo		погода в конаково скажи погода в конаково
Karataş için hava durumu		погода в кондопоге
Karkamış için hava durumu		погода в коне
Kocaköy için hava durumu		погода в копейске
Kocaköy 'de yarın için hava durumu		погода в копейске завтра
Kopenhag için hava durumu		погода в копенгагене
Karapürçek için hava durumu		погода в кордова
Karapürçek Sakarya ili için hava durumu		погода в кордово красноярского область
Karasu için hava durumu		погода в коренево
Köprübaşı Manisa ili için hava durumu		погода в коренево курской области
Kahta için hava durumu 		погода в коркино
Küçükyaya için hava durumu		погода в корне
Kuluncak için hava durumu		погода в королеве
Kuluncak'ta hafta sonu için hava durumu		погода в королеве на выходные
Koyulhisar  Sivas ili için iki haftalık hava durumu		погода в корсакове на две недели сахалинская область
Kocaiskan için hava durumu		погода в коряжме
Koslan için hava durumu		погода в кослане
Kangal  için aylik hava durumu		погода в костанае на месяц
Kale için hava durumu		погода в костомукше
Kale’de hafta sonu için hava durumu		погода в костомукше на выходные
Kale’de yarın için hava durumu göster		погода в костомукше на завтра покажи
Kale  için yarınki hava durumunu göster		погода в костомукше покажи на завтра
Kale’de on beş Temmuz iki bin on yedi için hava durumu		погода в костомукше пятнадцатое июля две тысячи семнадцать
Tekirdağ için hava durumu		погода в костроме
Tekirdağ'da yarın için hava durumu		погода в костроме завтра
Süleymanpaşa Tekirdağ ili için hava durumu		погода в костроме костромской области
Tekirdağ için hafta sonu hava durumu		погода в костроме на выходные
Tekirdağ'da yarın için hava durumu		погода в костроме на завтра
Bugün için Tekirdağ'da hava durumu		погода в костроме на сегодня
Tekirdağ Siirt  için hava durumu		погода в костроме погода в саратове на сегодня
Kadirli için hava durumu		погода в котельниково
Koçarlı için hava durumu		погода в котельниче
Köşk için hava durumu		погода в котласе
Kuyucak için hava durumu		погода в котово
Karpuzlu için aylik hava durumu		погода в кохме на месяц
Karayazı için hava durumu		погода в кочево
Karayazı'da yarın için hava durumu		погода в кочево на завтра
Karayazı için hava durumu		погода в коченево
Karayazı ilçesi için hava durumu		погода в коченевском районе
Karacasu için hava durumu		погода в кочках
Köprüköy için hava durumu		погода в кочкурово
Kadirli için hava durumu o Osmaniye'de		погода в кош агаче они в горно алтайске
Kumru için haftalık hava durumu		погода в кояново на неделю
Korgan için hava durumu		погода в краматорске
Kabataş  için hava durumu Yandex 		погода в красково яндекс
Kabadüz  için hava durumu		погода в красноармейске
Kabadüz iy için on günlük hava durumu		погода в красноармейском на десять дней
Kirazdere için on günlük hava durumu		погода в красновишерске на десять дней
Karakiraz için hava durumu		погода в красногвардейском
Karakiraz Adıge için hava durumu		погода в красногвардейском адыгея
Kalecik için hava durumu		погода в красногородске
Kalecik için hava durumu		погода в красногорске
Kalecik Ankara ili için hava durumu		погода в красногорске московской области
Kalecik için hava durumu		погода в красногорском на на
Kırşehir için hava durumu		погода в краснодаре
Kırşehir için dokuzuna kadar hava durumu		погода в краснодаре до девятого числа
Kırşehir için haftalık hava durumu		погода в краснодаре за неделю
Yarın  için Kırşehir'de hava durumu		погода в краснодаре завтра
Kırşehir Özbağ kasabası için hava durumu		погода в краснодаре знаменском поселке
Kırşehir’de hafta sonu için hava durumu		погода в краснодаре на выходные
Kırşehir için iki günlük hava durumu		погода в краснодаре на два дня
Kırşehir için iki haftalık  hava durumu		погода в краснодаре на две недели
Yarın için Kırşehir’de hava durumu		погода в краснодаре на завтра
Kırşehir için aylik  hava durumu		погода в краснодаре на месяц
Kırşehir için haftalık  hava durumu		погода в краснодаре на неделю
Bugün için Kırşehir’de hava durumu		погода в краснодаре на сегодня
Kırşehir'de şu an için hava durumu ve rüzgar hızı		погода в краснодаре на сейчас и скорость ветра
Kırşehir için üç günlük hava durumu		погода в краснодаре на три дня
Kırşehir için hava durumu gismeteo		погода в краснодаре по гисметео
Kırşehir için sekiz Ağustostan sonra  hava durumu		погода в краснодаре с восьмого августа
Yandex’te Kırşehir için hava durumu		погода в краснодаре яндекс
Güllühüyük köyü Kırşehir ili için hava durumu		погода в краснодарский край станица калининская
Avanoğlı Köyü Kırşehir ili için hava durumu		погода в краснодарском крае станице новоплатнировской
Kızılören için hava durumu		погода в красное на волге
Kıbrıscık  için hava durumu		погода в краснозаводске
Kilimli için hava durumu		погода в краснозерском
Kozlu için hava durumu		погода в краснознаменске
Kuzca için hava durumu		погода в красной горке
Kumtarla  Zonguldak ili için hava durumu		погода в красной поляне назаровский район
Korucak için hava durumu		погода в красной яруге
Kırıkhan için hava durumu		погода в краснокаменске
Kızılbel için saatlik hava durumu		погода в краснокамске по часам
Kargalar için haftalık hava durumu		погода в красном боре на неделю
Yarın için Keller’de hava durumu		погода в красном десанте на завтра
Kerimler  için hava durumu		погода в красном куте
Karakavuz için hava durumu		погода в красном луче
Yarın  için Karakavuz’da hava durumu		погода в красном луче на завтра
Bugün için Kızılören'de hava durumu		погода в красном на волге сегодня
Keskek için hava durumu 		погода в красном селе
Kadıoğlu için hava durumu  		погода в красном степном
Kahvecioğlu için hava durumu		погода в красном сулине
Kaleoğlu'da on iki Ağustos için hava durumu		погода в красном холме на двенадцатое августа
Karabaşlı için hava durumu		погода в красноперекопске
Kumtarla  için hava durumu		погода в краснополянское
Karahmetler için hava durumu		погода в краснотуранске
Krasnoturansk için haftalık hava durumu		погода в краснотуранске на неделю
Karahmetler için gece hava durumu		погода в краснотуранске ночью
Karahmetler için hava durumu		погода в краснотурьинске
Karahavuz için hava durumu		погода в красноуральске
Karahavuz için hava durumu		погода в красноусольске
Karamusa'da pazar günü için hava durumu		погода в красноуфимске на воскресенье
Kasımlı için hava durumu		погода в краснощеково
Sakarya için hava durumu		погода в красноярске
yarın için Sakarya’da hava durumu		погода в красноярске завтрашний
Sakarya'da  yarın hava durumu nasıl		погода в красноярске какая на завтра будет
Sakarya için on günlük hava durumu		погода в красноярске на ближайшие десять дней
Sakarya için beş günlük hava durumu		погода в красноярске на ближайшие пять дней
Sakarya için üç günlük hava durumu		погода в красноярске на ближайшие три дня
Sakarya'da  on beş Temmuzdan sonra hava durumu		погода в красноярске на вторую половину июля
Sakarya'da  yirmi bir  Temmuz için hava durumu		погода в красноярске на двадцать первое июля
Sakarya için on günlük hava durumu		погода в красноярске на десять дней
Sakarya için haftalık hava durumu		погода в красноярске на неделю
bugün için Krasnoyarsk’ta hava durumu		погода в красноярске на сегодня
Sakarya için on dört günlük hava durumu		погода в красноярске на четырнадцать дней
Sakarya'da  bir Eylül için hava durumu		погода в красноярске первого сентября
Sakarya'da  şu an için hava durumu		погода в красноярске сейчас
Bugün için Sakarya ili Serdivan  ilçesi Beşevler’de hava durumu		погода в красноярском крае рыбинском районе село двуречное на сегодня
Kalafatlı için hava durumu		погода в красных баках
yarın  için Kardeşler’de hava durumu		погода в красных четаях на завтра
Kremlin için hava durumu		погода в кремле
Kaymaklar için hava durumu		погода в креницах
bugün için Kayıkçılar’da hava durumu		погода в крестцах на сегодня
Girit için hava durumu		погода в крите
Karacaören için hava durumu		погода в кропоткине
Yarın  için Kabalaklı’da hava durumu		погода в кропоткине на завтра
Bugün için Kabaca’da hava durumu		погода в кропоткине на сегодня
Yarın için Artvin ili Şavşat’ta hava durumu		погода в кротово приозерского района на завтра
Karakoç için hava durumu		погода в крутом майдане
Kırım için hava durumu krym şehir		погода в крым крым с города
Keller için hava durumu		погода в крымске
Kırım için hava durumu		погода в крыму
Kırım'da Ağustos ayı için hava durumu		погода в крыму в августе
Kırım'da pazar günü için hava durumu		погода в крыму на воскресенье
Kırım için on günlük hava durumu		погода в крыму на десять дней
Yarın   için Kırım’da hava durumu		погода в крыму на завтра
Kırım'da Ağustos sonu Eylül başına kadar için hava durumu		погода в крыму на конец августа начало сентября
Kırım'da Eylül başından sonuna kadar için hava durumu		погода в крыму на конец сентября начало сентября
Kırım'da bir Eylül için hava durumu		погода в крыму на первое сентября
Kırım'da Eylül ayı için hava durumu		погода в крыму на сентябрь
Kırım için on dört günlük hava durumu		погода в крыму на четырнадцать дней
Ks için hava durumu		погода в кс
Kemalpaşa için hava durumu		погода в кстове
Kemalpaşa için hava durumu		погода в кстово
Kemalpaşa için günlük hava durumu		погода в кстово на день
Bugün için Kemalpaşa’da hava durumu		погода в кстово на сегодня
Kemalpaşa ilçesi Aşağıkızılca için hava durumu		погода в кстовском районе в нижнем
Kamberler için hava durumu		погода в кудымкаре
Kamberler'de yirmi bir Temmuz iki bin on yedi yıllında için hava durumu		погода в кудымкаре на двадцать первое июля две тысячи семнадцатого года
Kızılüzüm  için hava durumu		погода в куеде
Karapürçek için hava durumu		погода в кузнецке
Karapürçek  için beş günlük hava durumu		погода в кузнецке на пять дней
Kışla için haftalık hava durumu		погода в кузоватово на неделю
Kıyıcak için hava durumu		погода в кузьминских отвержках
Gazientep ili Şehitkamil ilçesi Bağbaşı için hava durumu		погода в кузьмолово ленинградской области всеволожский район
Bugün için Gazientep bölgesi Bağbaşı'nda hava durumu		погода в кузьмолово ленинградской области на сегодня
Kızılbel için hava durumu		погода в куиде
Yarın için Kızılca’da hava durumu		погода в кулатке на завтра
Yarın  için Kızılcakese’de hava durumu		погода в кулебаках на завтра
Kızılcapınar için haftalık hava durumu		погода в кули на неделю
Kocaali için hava durumu		погода в куликово
Kocaaman için hava durumu		погода в куменах
Koramanlar için hava durumu		погода в кунгуре
Yarın için Koramanlar’da hava durumu		погода в кунгуре на завтра
Koramanlar’da şu an için hava durumu		погода в кунгуре сейчас
Koramanlar’da şu an için ve yarın hava durumu		погода в кунгуре сейчас и завтра
Köroğlu için hava durumu		погода в кунье
Yarın için Köroğlu’da hava durumu		погода в кунье на завтра
Küçüktekke için on günlük hava durumu		погода в купавне на десять дней
Küçüktekke  için iki günlük hava durumu		погода в купино на два дня
Bugün için Küçüktekke ’de ayrıntılı hava durumu		погода в купино на сегодня подробно
İstanbul  Kupçino için saatlik hava durumu		погода в купчино в санкт петербурге по часам
Kulah  için hava durumu		погода в кураково
Tokat için hava durumu		погода в кургане
Tokat için hava durumu gismeteo		погода в кургане гисметео
Yarın için Tokat’ta hava durumu		погода в кургане завтра
Tokat için on günlük hava durumu		погода в кургане на десять дней
Yarın için Tokat’ta hava durumu		погода в кургане на завтра
Tokat için haftalık hava durumu		погода в кургане на неделю
tatil bölgesinde Side için üç günlük hava durumu		погода в курортном районе должанка на три дня
Manisa  için hava durumu		погода в курске
Manisa 'da  on iki Ağustos için hava durumu		погода в курске на двенадцатое августа
Manisa  için on günlük hava durumu		погода в курске на десять дней
Yarın için Manisa'da  hava durumu		погода в курске на завтра
Bugün Manisa  için bir kaç saatlik hava durumu		погода в курске на несколько часов
Bugün için Manisa'da hava durumu		погода в курске на сегодня
Bugün için Manisa'da hava hava durumunu bak lütfen		погода в курске на сегодня посмотри пожалуйста
Manisa  için üç günlük hava durumu		погода в курске на три дня
Manisa  için hava durumunu söyle		погода в курске скажи
Küçükkaymaz için hava durumu		погода в курчанской
Kurtalr için hava durumu		погода в курчатове
Bugün için Kurchatov’da hava durumu		погода в курчатове на сегодня
Kangal  için hava durumu		погода в кустанае
Kangal  için haftalık hava durumu		погода в кустанае на неделю
Yarın için Kangal ’da hava durumu sen aptal tavuksun		погода в кустанай завтра ты тупая курица
Kışlaköy için hava durumu gismeteo		погода в кутулике гисметео
mutfak için hava durumu		погода в кухне
Kumpınar  için hava durumu		погода в кучугурах
Kurtalan ilçesi için haftalık hava durumu		погода в кушнаренковском районе на неделю
Kahramankazan için hava durumu		погода в кущевской
Kahramankazan ilçesi için hava durumu		погода в кущевском районе
Yarın için Kızıltepe’de hava durumu		погода в куяново на завтра
Aydın ili Karataş için hava durumu		погода в куяче алтайский край
Kırgızistan için hava durumu		погода в кыргызстане
Kahta için hava durumu		погода в кырене
Kızılören için hava durumu		погода в кыштыме
Mamak  için hava durumu		погода в лабинске
Yarın için Mamak ’ta hava durumu		погода в лабинске на завтра
Bugün için Mamak ’ta hava durumu		погода в лабинске на сегодня
Muratpaşa  için hava durumu		погода в лабытнангах
Lagan Disney için hava durumu		погода в лагани на дисней
Murgul  için hava durumu		погода в лагерево
Manyas için hava durumu		погода в лаголово
Mutki için hava durumu		погода в ладожской
yarın için Mudurnu’da hava durumu		погода в лазаревке завтра
Mucur için aylık hava durumu		погода в лазаревское на месяц
Mucur için hava durumu		погода в лазаревской
Mucur için hava durumu		погода в лазаревском
Kırşehir ili Mucur için beş günlük hava durumu		погода в лазаревском краснодарском крае на пять дней вперед
Bugün için Sinop Boyabat’ta hava durumu		погода в лазаревском на сегодня сочи
Mucur icin Ağustos’un sekizden yirmisine kadar hava durumu		погода в лазаревском с восьмого августа по двадцатое августа семнадцатого года
Mucur için hava durumu		погода в лазревском
İç Anadolu bölgesi Aksaray için hava durumu		погода в лаишево республика татарстан
Finlyandiya Lamppi için hava durumu		погода в лампе финляндия
Marmaraereğlisi için aylık hava durumu		погода в лангепасе на месяц
Marmaraereğlisi'nde bir Ağustos için hava durumu		погода в лангепасе на первое августа
Muhsinler için hava durumu		погода в лаппеенранте
Musausta için hava durumu		погода в лахденпохье
Mekekler için on günlük hava durumu		погода в лебедяни на десять дней
Kocaeli bölgesi Gölcük için haftalık hava durumu		погода в лебяжье кировская область на всю неделю
Tokat ili Niksar'da hafta sonu için hava durumu		погода в лебяжье курганской области на выходные
Mufetişler için hava durumu 		погода в ленинауле
Mufetişler için on günlük hava durumu		погода в ленинауле на десять дней
Gazientep için hava durumu		погода в ленинграде
Gazientep için hava durumu		погода в ленинградской
Gazientep ili için hava durumu		погода в ленинградской области
Merzifon için haftalık hava durumu		погода в лениногорске на неделю
Mumcuoğlu için hava durumu		погода в ленинск кузнецке
Mumcuoğlu'nda Temmuz’un yirmi sekizden yirmi dokuzuna kadar olan hava durumu		погода в ленинск кузнецкий двадцать восьмого двадцать девятого июля
Mazgirt'te şu an için hava durumu		погода в ленинске сейчас
Yarın   için Mazgirt ilçesi Tunceli ilinde hava durumu		погода в ленинском районе города тулы на завтра
Sakarya  Arifiye ilçesi için hava durumu		погода в ленинском районе красноярска
Marmara Bölgesi Arifiye için hava durumu		погода в ленске республика саха якутия
Muherremler için hava durumu		погода в лермонтово
Mustakimler için hava durumu		погода в лесах
Muradiye için hava durumu tarih		погода в лесозаводске даты
Muradiye  için haftalık hava durumu		погода в лесозаводске на неделю
Bugün akşam için Muradiye’de hava durumu		погода в лесозаводске на сегодняшний вечер
Muradiye  için hava durumu lütfen		погода в лесозаводске пожалуйста
Mutki için hava durumu		погода в лесосибирске
Alaplı'da hafta sonu için hava durumu		погода в ливадии на выходные
Bugün için Alaplı'da hava durumu		погода в ливадии на сегодня
Mengen  için hava durumu		погода в ливнах
Yarın için Mengen’de hava durumu		погода в ливнах на завтра
Mengen için haftalık hava durumu		погода в ливнах на неделю
Mudanya için hava durumu		погода в лиде
Bugün akşam için Mudanya’da hava durumu		погода в лиде на сегодня вечером
Müfetişler için hava durumu		погода в ликино дулево
yarın için Nevşehir ili Hacıbektaş’ta hava durumu		погода в линево новосибирская область на завтра
Yarın için Çek Cumhuriyeti Lipec’de hava durumu		погода в липеце чехия на завтра
Merkezefendi  için hava durumu		погода в липецке
Merkezefendi  için hava durumu		погода в липецке на
Merkezefendi 'de pazar günü için hava durumu		погода в липецке на воскресенье
Merkezefendi  için iki günlük hava durumu		погода в липецке на два дня
Bugün için Merkezefendi ’de hava durumu		погода в липецке на сегодня
Bugün için Merkezefendi ’de hava durumu kaç derece		погода в липецке на сегодня какая температура сейчас
Merkezefendi  için üç günlük hava durumu		погода в липецке на три дня
Merkezefendi ’de tüm gün  için hava durumu		погода в липецке на целый день
Merkezefendi ’de altısı  için hava durumu		погода в липецке на шестое число
Merkezefendi  ilçes için hava durumu		погода в липецкой области
Muherremşah için hava durumu		погода в липовке
Madenler için hava durumu		погода в лисках
Yarın için Madenler'de hava durumu		погода в лисках на завтра
Madenler için üç günlük hava durumu		погода в лисках на три дня
Musabeyli için hava durumu		погода в листвянке
Mahmutoğlu için hava durumu		погода в лихославле
Malatya için hava durumu		погода в лобне
Yarın için Malatya’da hava durumu		погода в лобне завтра
Aydın ili Nazilli ilçesi Bağcıllı için hava durumu		погода в логовском алтайского края первомайского района
 Nazilli ilçesi Bağcıllı  için hava durumu		погода в логовском первомайского района
Aydın bölgesi  Nazilli ilçesi Bağcıllı'da hava durumu		погода в логовском первомайского района алтайского края
Midyat için hava durumu anasını satıyım		погода в лодейном поле твою мать
Mut için hava durumu		погода в локте
Mut için hava durumu rüzgarlı		погода в локте ветер
Mut ilçesi Karacaoğlan için hava durumu		погода в локтевском районе горняке
Londra için hava durumu		погода в лондоне
Kırşehir ili için hava durumu		погода в лоо краснодарский край
Menteşe  ve Köyceğiz için hava durumu		погода в лопатках и в каскаре
Milas'ta yirmi iki Temmuz için hava durumu		погода в лосино петровске двадцать два июля
Milas'ta şu an için hava durumu		погода в лосино петровском текущий момент
Bugün için Milas'ta hava durumu		погода в лосинопетровске сегодня
Mahmutlu için hava durumu		погода в лотках
Mollaosmanlar için hava durumu		погода в лотошино
Meşeköyi için hava durumu		погода в лоухах
Lugansk için hava durumu		погода в луганске
Yarından sonra Lugansk için hava durumu		погода в луганске послезавтра
Bugün için Lugansk’ta hava durumu		погода в луганске сегодня
Yarın   için Luga’da hava durumu		погода в луге на завтра
Medetsiz için haftalık hava durumu		погода в луге на неделю
Bugün için Medetsiz’de hava durumu		погода в луге на сегодня
Gece ve gündüz için Medetsiz'de hava durumu		погода в луге ночью и днем
Manavlı için hava durumu		погода в лузино
Bugün için Muharremşah’ta hava durumu		погода в лукоянове сегодня
Niğde için haftalık hava durumu		погода на неделю в новошахтинске
Ordu için haftalık hava durumu		погода на неделю в омске
başka günler için haftalık hava durumu		погода на неделю в остальные дни
Pamukova için haftalık hava durumu		погода на неделю в пензе
İstanbul için haftalık hava durumu		погода на неделю в питере
Karadeniz bölgesi   Bandırma   ilçesi Ballıpınar köyü için haftalık hava durumu		погода на неделю в покровке октябрьского района приморского края
Giresun için haftalık hava durumu		погода на неделю в ростове на дону
Rize ili  için haftalık hava durumu		погода на неделю в ростовской области
Karaman için haftalık hava durumu		погода на неделю в рязани
Karaman ili Bozyaka  köyü için haftalık hava durumu		погода на неделю в рязанской области поселок старожилово
İstanbul  için haftalık hava durumu		погода на неделю в санкт петербурге
Siirt  için haftalık hava durumu		погода на неделю в саратове
Ağrı köyü için haftalık hava durumu		погода на неделю в селе александровском
Samandağ  için haftalık hava durumu		погода на неделю в серпухове
Silvan için haftalık hava durumu		погода на неделю в смоленске
Safranbolu için haftalık hava durumu		погода на неделю в солнечногорске
Sinop için haftalık hava durumu		погода на неделю в сочи
Bozyaka  için haftalık hava durumu		погода на неделю в старожилово
Suluova için haftalık hava durumu		погода на неделю в сургуте
Tekirdağ için haftalık hava durumu		погода на неделю в твери
Tunceli için haftalık hava durumu		погода на неделю в туле
Trabzon için haftalık hava durumu		погода на неделю в тюмени
Uşak için haftalık hava durumu		погода на неделю в уфе
Urfa için haftalık hava durumu		погода на неделю в уяре
Hakkari için haftalık hava durumu		погода на неделю в холмске
Karadeniz bölgesi  Taşova  ilçesi için haftalık hava durumu		погода на неделю в хорольский район приморский край
Taşlıçay  için haftalık hava durumu		погода на неделю в цивильске
Çanakkale  için haftalık hava durumu		погода на неделю в чебоксарах
Çorlu için haftalık hava durumu		погода на неделю в челябинске
Çankırı için haftalık hava durumu		погода на неделю в череповце
Çorum  için haftalık hava durumu		погода на неделю в черногорске
Çıldır için haftalık hava durumu		погода на неделю в чите
Çine  için haftalık hava durumu		погода на неделю в чувашии
Şırnak  için haftalık hava durumu		погода на неделю в шадринске
Şabanözü için haftalık hava durumu		погода на неделю в шахта
Şahinbey  için haftalık hava durumu		погода на неделю в шахунье
Erzin  için haftalık hava durumu		погода на неделю в электростали
Yozgat  için haftalık hava durumu		погода на неделю в ярославле
Van için haftalık hava durumu		погода на неделю великий новгород
Vize için haftalık hava durumu		погода на неделю во всеволожске
Varto için haftalık hava durumu		погода на неделю воркута
önümüzdeki hafta için hava durumu		погода на неделю вперед
Acıgöl  şehri için haftalık hava durumu		погода на неделю город алагир
Aksaray şehri için haftalık hava durumu		погода на неделю город альметьевск
Kayseri şehri için haftalık hava durumu		погода на неделю город краснокамск
Karadeniz bölgesi  Gümüşhane  şehri için haftalık hava durumu		погода на неделю город находка приморского края
Bayburt  şehri için haftalık hava durumu		погода на неделю город пермь
Silifke  şehri için haftalık hava durumu		погода на неделю город салават
Salihli  şehri için haftalık hava durumu		погода на неделю город северск
Ünye şehri için haftalık hava durumu		погода на неделю город уссурийск
Çankırı şehri için haftalık hava durumu		погода на неделю город черемхово
Düziçi  için haftalık hava durumu		погода на неделю давлеканово
saat dokuz için haftalık hava durumu		погода на неделю девять часов
Kırşehir ili Çiçekdağı için haftalık hava durumu		погода на неделю джумба краснодарский край
Elâzığ  haftalık hava durumu		погода на неделю екатеринбург
Edirne  haftalık hava durumu		погода на неделю елабуга
Karadeniz Ereğli  haftalık hava durumu		погода на неделю канск
Kocaeli haftalık hava durumu		погода на неделю кировск
Milas haftalık hava durumu		погода на неделю магнитогорск
Murgul haftalık hava durumu		погода на неделю минск
Ankara  haftalık hava durumu		погода на неделю москва
Malkara haftalık hava durumu		погода на неделю мурманск
haftalık haftalık hava durumu 		погода на неделю на неделю
Nusaybin  için haftalık hava durumu		погода на неделю нарофоминска
haftalık hava durumu ama Yandexta değil		погода на неделю но не в яндексе
Nevşehir  haftalık hava durumu		погода на неделю новосибирск
Ordu haftalık hava durumu		погода на неделю омск
Ödemiş haftalık hava durumu		погода на неделю орел
Pamukova haftalık hava durumu		погода на неделю пенза
Patnos  haftalık hava durumu		погода на неделю печенга
Marmara Bölgesi Bilecik için haftalık hava durumu accuweather		погода на неделю по карелии петрозаводск гисметео
haftalık hava durumu lütfen		погода на неделю пожалуйста
Batman haftalık hava durumu		погода на неделю полевской
Paşalı köyü haftalık hava durumu		погода на неделю поселок приволжский
Süphandere köyü haftalık hava durumu		погода на неделю поселок седово
Ordu için haftalık hava durumunu göster		погода на неделю посмотреть в омске
Silopi haftalık hava durumu		погода на неделю самара
İstanbul  haftalık hava durumu		погода на неделю санкт петербург
Sinop için Eylül ayının haftalık hava durumu		погода на неделю сентябрь месяц в сочи
Silvan haftalık hava durumu		погода на неделю смоленск
Suluova haftalık hava durumu		погода на неделю сургут
Karataş ilçesi haftalık hava durumu		погода на неделю ханкайский район
Çıldır için haftalık hava durumu		погода на неделю чите
Çine  haftalık hava durumu		погода на неделю чувашия
Yalova haftalık hava durumu		погода на неделю якутск
Aydın ili Yenipazar haftalık hava durumu		погода на неделю яровое алтайский край
Nurdağı haftalık hava durumu		погода на ниноцминда
gece hava durumu		погода на ночь
Söke şehri için gece hava durumu		погода на ночь в городе собинка
Yüksekova  için gece hava durumu		погода на ночь в ельце
bugün gece hava durumu		погода на ночь сегодня
Orhangazi  için hava durumu		погода на оби
on biri için hava durumu		погода на одиннадцатое
on bir Temmuz için hava durumu		погода на одиннадцатое июля
iki bin on yedi yılın on bir Temmuzu için hava durumu 		погода на одиннадцатое июля две тысячи семнадцатого года в самаре
on biri için hava durumu		погода на одиннадцатое число
Burdur gölü için hava durumu		погода на озере банное
Burdur gölünde hava durumu		погода на озере банном
Köyceğiz gölü hava durumu		погода на озере кандрыкуль
Manyas  gölü hava durumu		погода на озере пиренга мончегорск
Yirmi yedi Temmuz'da Sapanca  gölü hava durumu		погода на озере селигер на двадцать седьмое июля
Gönen ilçesi için hava durumu		погода на ольгинский район
Orak adası  için hava durumu		погода на ольхоне
Öreke Kayalıkları hava durumu		погода на орто курган
İncir adasında hava durumu		погода на острове итуруп
Hainan Eyaletinde hava durumu		погода на острове хайнань
Palandöken Barajında hava durumu		погода на павловском водохранилище
Polat'ta hava durumu		погода на палиха
bir Ağustos için hava durumu		погода на первое августа
bir Ağustos için hava durumu türkçe		погода на первое августа русски
bir sıfır yedi iki bin on yedide İzmir şehrinde hava durumu		погода на первое ноль седьмое две тысячи семнадцатого город иркутск
bir Eylül hava durumu		погода на первое сентября
Vakfıkebir bir Eylül hava durumu		погода на первое сентября воткинск
iki bin yirmi yılın bir Eylül hava durumu		погода на первое сентября две тысячи двадцатый год
Ağustos ayının birinci kısmı için hava durumu		погода на первую половину августа
Ay gezegeninde hava durumu		погода на планете луна
sahilde hava durumu		погода на побережье
yirmi beş Ağustostan otuz bir Ağustosa kadar Karadeniz sahili için hava durumu		погода на побережье черного моря с двадцать пятого августа по тридцать первое августа
Nevşehir 'de hava durumu		погода на погода в новосибирске
on yedisine hava durumu		погода на погода на семнадцатое число
Eylül ayına hava durumu		погода на погода на сентябрь
pazartesine hava durumu		погода на понедельник
Varto pazartesine hava durumu		погода на понедельник в волжске
Yozgat  pazartesine hava durumu		погода на понедельник в ярославле
 Kuşadası için pazartesine hava durumu		погода на понедельник на камне оби
pazartesine ayrıntılı hava durumu		погода на понедельник подробно
Saruhanlı'da pazartesine hava durumu		погода на понедельник слободском
yarından sonra Bingöl'de hava durumu		погода на послезавтра в балашихе
yarından sonra Fatsa'da hava durumu		погода на послезавтра в волхове на
yarından sonra Osmancık'ta hava durumu		погода на послезавтра в осинниках
yarından sonra Saray'da hava durumu		погода на послезавтра в сарапуле
yarından sonra Uşak 'ta hava durumu		погода на послезавтра в улан удэ
yarından sonra Hakkari'de hava durumu		погода на послезавтра в холмске
yarından sonra Giresun şehrinde hava durumu		погода на послезавтра город ростов на дону
yarından sonra Kula'da hava durumu		погода на послезавтра калач
yarından sonra Avanos'ta hava durumu		погода на послезавтра на в сталинке
yarından sonra ve ondan sonra hava durumu		погода на послезавтра после послезавтра
Pukhet'te hava durumu		погода на пукхете
Pekmezci'de hava durumu		погода на пульте
Phuket'te hava durumu		погода на пхукете
Tayland Phuket'te hava durumu		погода на пхукете тайланд
Patnos'ta hava durumu		погода на пятигорск
on beş Ağustos'a hava durumu		погода на пятнадцатое августа
İslahiye on beş Ağustos'a hava durumu		погода на пятнадцатое августа в иркутске
on beş Temmuz için hava durumu		погода на пятнадцатое июля
Marmara bölgesi Çanakkale şehri için on beş günlük hava durumu		погода на пятнадцать дней город радужный хмао
Cuma'ya hava durumu		погода на пятницу
Cuma ve Cumartesine hava durumu		погода на пятницу и субботу
Cuma'ya  Kuşadası için hava durumu		погода на пятницу камень на оби
beş Ağustos'a hava durumu		погода на пятое августа
beş Temmuz'a hava durumu		погода на пятое июля
beş Eylül'e hava durumu		погода на пятое сентября
ayın beşine hava durumu		погода на пятое число
beşi pazar günü için hava durumu		погода на пятое число воскресенье
Çorlu şehri beşi için hava durumu		погода на пять в городе челябинске
beş günlük hava durumu		погода на пять дней
Yüksekören beş günlük hava durumu		погода на пять дней ялуторовск
işte hava durumu		погода на работе
Rize'de hava durumu		погода на разъезде судьба
Horasan'da hava durumu		погода на родосе
mgm sitesinde hava durumu tahminleri		погода на рп пять
Rusça hava durumu		погода на русском
Sandıklı için üç günlük hava durumu		погода на сабетте на три дня
accuweather sitesinde hava durumu		погода на сайте гисметео
Silopi hava durumu		погода на самара
Yarın Silopi için hava durumu		погода на самаре завтра
Salmanlı  için hava durumu		погода на самотет
Samuy Ağustos ayı için hava durumu		погода на самуи в августе
Susurluk ilçesi tüm Eylül ayı için hava durumu		погода на свободненский район на сентябрь на полностью месяц
Sındırgı'da hava durumu		погода на севане
kuzeyde hava durumu		погода на севере
kuzey kutbu için hava durumu		погода на северном полюсе
19:00 bugün için hava durumu		погода на сегодня , 19:00
Ankara  için bugünkü hava durumu		погода на сегодня Москва
Akdeniz bölgesi  Burdur şehri için bugünkü hava durumu		погода на сегодня амурская область город белогорск
Akdeniz bölgesi  Burdur için bugünkü hava durumu		погода на сегодня белогорск амурская область
Bulancak için bugünkü hava durumu		погода на сегодня большой камень
Bulancak bugün ve yarın için hava durumu		погода на сегодня большой камень на завтра
Beypazarı için bugünkü hava durumu		погода на сегодня буденновск
Antalya için bugünkü hava durumu		погода на сегодня в анапе
Akşehir  için bugünkü hava durumu		погода на сегодня в анжеро судженске
Alaşehir için bugünkü hava durumu		погода на сегодня в ардатове
Akçaabat  için bugünkü hava durumu		погода на сегодня в архангельске
Burhaniye için bugünkü hava durumu		погода на сегодня в бачей каве
Bucak için bugünkü hava durumu		погода на сегодня в белгороде
Biga  için bugünkü hava durumu		погода на сегодня в бердске
Bor için bugünkü hava durumu		погода на сегодня в бийске
Bolvadin  için bugünkü hava durumu		погода на сегодня в борисове
Van  için bugünkü hava durumu		погода на сегодня в варне
Vakfıkebir için bugünkü hava durumu		погода на сегодня в витебске
Vezirköprü  için bugünkü hava durumu		погода на сегодня в волгограде
Velicanlı için bugünkü hava durumu		погода на сегодня в волгодонске
 Tavşanlı için bugünkü hava durumu		погода на сегодня в воронеже
Vayvaylı için bugünkü hava durumu		погода на сегодня в воскресенске
Gaziantep için bugünkü hava durumu		погода на сегодня в голицыно
Gaziantep için bugünkü hava durumu lan		погода на сегодня в голицыно блядь
Giresun için bugünkü hava durumu		погода на сегодня в горно алтайске
Mamak  için bugünkü hava durumu 		погода на сегодня в городе лабинске
Malatya için bugünkü hava durumu		погода на сегодня в городе махачкала
Nusaybin için bugünkü hava durumu		погода на сегодня в городе нефтегорск
Narlıören  için bugünkü hava durumu		погода на сегодня в городе новоаннинском
Geyve  için bugünkü hava durumu		погода на сегодня в грозном
Dörtyol  için bugünkü hava durumu		погода на сегодня в дербенте
Side için bugünkü hava durumu		погода на сегодня в должанке
Edirne  için bugünkü hava durumu		погода на сегодня в елабуге
Yüksekova  için bugünkü hava durumu		погода на сегодня в ельце
Varto ilçesi için bugünkü hava durumu		погода на сегодня в заволжском районе
Nizip için bugünkü hava durumu		погода на сегодня в зеленогорске
 Nazilli  için bugünkü hava durumu 		погода на сегодня в зеленограде
İzmir için bugünkü hava durumu		погода на сегодня в иркутске
Kahramanmaraş için bugünkü hava durumu		погода на сегодня в казани
Siirt  bölgesi Karabulak için bugünkü hava durumu		погода на сегодня в карабулаке саратовская область
Korkuteli için bugünkü hava durumu		погода на сегодня в клину
Kalecik için bugünkü hava durumu		погода на сегодня в красногорске
Kırşehir için bugünkü hava durumu		погода на сегодня в краснодаре
Sakarya için bugünkü hava durumu		погода на сегодня в красноярске
Nevşehir  ili Kozaklı için bugünkü hava durumu		погода на сегодня в криводановке новосибирской области
Kaşobası için bugünkü hava durumu		погода на сегодня в кропоткине
Tokat için bugünkü hava durumu		погода на сегодня в кургане
Manisa  bugün için saatlik hava durumu		погода на сегодня в курске по часам
Kalemli için bugünkü hava durumu		погода на сегодня в курумоче
Merkezefendi  için için bugünkü hava durumu		погода на сегодня в липецке
Turgutlu Musacalı için bugünkü hava durumu		погода на сегодня в малиновке тамбова
Mustafalar için bugünkü hava durumu		погода на сегодня в миловке
Ankara  için bugünkü hava durumu		погода на сегодня в москве
Hacıbektaş için bugünkü hava durumu		погода на сегодня в набережных челнах
Harbiye için bugünkü hava durumu		погода на сегодня в нариманове
Hakkâri için bugünkü hava durumu		погода на сегодня в нефтекамске
Himmetli için bugünkü hava durumu		погода на сегодня в нижней туре
Halilbeyli için bugünkü hava durumu		погода на сегодня в нижнеудинске
Nikopol için bugünkü hava durumu		погода на сегодня в никополе
Nevşehir  için bugünkü hava durumu		погода на сегодня в новосибирске
Uludere için bugünkü hava durumu		погода на сегодня в онеге
Tuzla Çayı için bugünkü hava durumu		погода на сегодня в оше
Kozan ilçesi Pekmezci için bugünkü hava durumu		погода на сегодня в пешково нерчинский район
İstanbul  için bugünkü hava durumu		погода на сегодня в питере
ayrıntılı günlük hava durumu		погода на сегодня в подробностях
Gazientep bölgesi Karababa köyü için bugünkü hava durumu		погода на сегодня в поселке кузьмолово ленинградской области
Beydili kasabası  için bugünkü hava durumu		погода на сегодня в поселке октябрьский городского типа
Savaşköy için bugünkü hava durumu		погода на сегодня в поселке селятино
Balıkesir için bugünkü hava durumu		погода на сегодня в приморско
Pekmezli için bugünkü hava durumu		погода на сегодня в прокопьевске
Pancarlı için bugünkü hava durumu		погода на сегодня в пушкине
Reyhanlı  için bugünkü hava durumu		погода на сегодня в реутово
Serdivan  için bugünkü hava durumu		погода на сегодня в рыбинске
İstanbul için bugünkü hava durumu		погода на сегодня в санкт петербурге
Söke için bugünkü hava durumu		погода на сегодня в саяногорске
Burdur ili Bucak ilçesi Avdancık köyü için bugünkü hava durumu		погода на сегодня в селе алексеевка яковлевский район белгородская область
Soma için bugünkü hava durumu		погода на сегодня в семилуках
Salihli için bugünkü hava durumu		погода на сегодня в серпухове
Belpınar köyü için bugünkü hava durumu		погода на сегодня в станице пшехской
Sevindi için bugünkü hava durumu		погода на сегодня в старом осколе
Suruç  için bugünkü hava durumu		погода на сегодня в стерлитамаке
Tekirdağ için bugünkü hava durumu		погода на сегодня в твери
Terme için bugünkü hava durumu		погода на сегодня в тольятти
Ordu için bugünkü hava durumu		погода на сегодня в томске
Trabzon için bugünkü hava durumu		погода на сегодня в тюмени
Oltu için bugünkü hava durumu		погода на сегодня в ульяновске
Kırşehir ili Kaman ilçesi için bugünkü hava durumu		погода на сегодня в успенском районе краснодарского края
Kulu  için bugünkü hava durumu 		погода на сегодня в хабарах
Kulu bugün akşam için hava durumu		погода на сегодня в хабаровске вечером
Kulu bugün akşam hava durumu		погода на сегодня в хабаровске на ночь
Havza  için bugünkü hava durumu		погода на сегодня в химках
Hakkari için bugünkü hava durumu		погода на сегодня в холмске
Çanakkale  için bugünkü hava durumu		погода на сегодня в чебоксарах
Şarköy için bugünkü hava durumu		погода на сегодня в шексне
Şemdinli için bugünkü hava durumu		погода на сегодня в щучинске
erotik günlük hava durumu		погода на сегодня в эротический
Sivas için bugünkü hava durumu		погода на сегодня в южно сахалинске
Yalıkavak için bugünkü hava durumu		погода на сегодня в ялте
Alisa, bugün akşam için hava durumu 		погода на сегодня вечером алиса
Yüreğir için bugünkü hava durumu		погода на сегодня во ржеве
Vakfıkebir için bugünkü hava durumu		погода на сегодня воткинск
Yozgat için bugünkü hava durumu		погода на сегодня город йошкар ола
Bandırma   için bugünkü hava durumu		погода на сегодня город октябрьский
Siirt  için bugünkü hava durumu		погода на сегодня город саратов
Dursunbey için bugünkü hava durumu		погода на сегодня домодедово
Elâzığ  için bugünkü hava durumu		погода на сегодня екатеринбург
bugün yarın ve ondan sonrası için hava durumu		погода на сегодня завтра послезавтра
Bigadiç ilçesi Yolbaşı için bugünkü hava durumu		погода на сегодня заюково баксанский район
bugün ve yarın için Balatlı ve Kayalıdere hava durumu		погода на сегодня и завтра в батайске в койсуге по карте
bugün ve yarın için Mecidiye hava durumu		погода на сегодня и завтра в наровчате
bugün ve yarın için Söğütlü hava durumu		погода на сегодня и завтра в суворове
Zara bugün ve yarın için hava durumu		погода на сегодня и завтра зеленодольск
Kahramanmaraş için bugünkü hava durumu		погода на сегодня казань
bugünkü hava durumunu söyler misin, lütfen		погода на сегодня какая будет скажи пожалуйста
Bugün hava nasıl		погода на сегодня какой
Karaman bugünkü hava durumu		погода на сегодня калининград
Kocaali bugünkü hava durumu		погода на сегодня каспийский
Konya bugünkü hava durumu		погода на сегодня кингисепп
Kocaeli bugünkü hava durumu		погода на сегодня киров
Kınık bugünkü hava durumu		погода на сегодня кировск
Karabük bugünkü hava durumu		погода на сегодня клинцы
Sakarya bölgesi Kaynarca bugünkü hava durumu		погода на сегодня кодинск красноярский край
Kırşehir bugünkü hava durumu		погода на сегодня краснодар
Lüleburgaz bugünkü hava durumu		погода на сегодня люблино
Mersin için bugünkü hava durumu		погода на сегодня мензелинск
Malıhıdırlı bugünkü hava durumu		погода на сегодня месягутова
Ordu Mesudiye bugünkü hava durumu		погода на сегодня мирная долина омск
Ankara  bugünkü hava durumu		погода на сегодня москва
Maraşlı bugünkü hava durumu		погода на сегодня мыски
Bulancak bugün yarın ve ertesi gün için hava durumu		погода на сегодня на завтра на послезавтра большой камень
bugünkü saatlik hava durumu		погода на сегодня на час
Narlık için bugünkü hava durumu		погода на сегодня новомосковске
Yalova'ta bugün hava durumu sıfıra düşüyor gismeteo		погода на сегодня ноль яновск гисметео
bugünkü gece için hava durumu		погода на сегодня ночь
İzmir için bugünkü gece hava durumu		погода на сегодня ночью иркутске
Ordu bugünkü hava durumu		погода на сегодня омск
Pamukova bugünkü hava durumu		погода на сегодня пенза
Posyağbasan bugünkü hava durumu		погода на сегодня подольск
Bugün için detaylı hava durumu		погода на сегодня подробно
Süphandere köyü bugün için hava durumu		погода на сегодня поселок седово
Yumurtalık ilçesi Yeşilköy köyü için bugünkü saatlik hava durumu		погода на сегодня почасовая в поселке любохна дятьковского района
Patnos için bugünkü hava durumu		погода на сегодня пятигорск
Tacikistan Cumhuriyeti İsfara şehri için bugünkü hava durumu		погода на сегодня республика таджикистан город исфара
Giresun için bugünkü hava durumu		погода на сегодня ростов на дону
Serdivan  için bugünkü hava durumu		погода на сегодня рыбинск
sabahtan akşama kadar günlük hava durumu		погода на сегодня с утра до вечера
İstanbul  için bugünkü hava durumu		погода на сегодня санкт петербург
Siirt  için bugünkü hava durumu		погода на сегодня саратов
Oruçlu köyü için bugünkü hava durumu		погода на сегодня село рошни чу
Tokat için bugünkü hava durumu		погода на сегодня тулун
Karadeniz bölgesi  Çorum için bugünkü hava durumu		погода на сегодня угловое приморский край
Uşak için bugünkü hava durumu		погода на сегодня улан удэ
Örendere için bugünkü hava durumu 		погода на сегодня уразова
Özbaşı için bugünkü hava durumu		погода на сегодня усолье сибирское
Uşak için bugünkü hava durumu		погода на сегодня уфа
Kulu  için bugünkü hava durumu		погода на сегодня хабаровск
Şabanözü için bugünkü hava durumu		погода на сегодня шахты
Adana ili Karataş ilçesi Adalı için bugünkü hava durumu		погода на сегодня шекснинский район вологодская область патио
Şemdinli için bugünkü hava durumu		погода на сегодня щучинске
Ereğli için bugünkü hava durumu		погода на сегодня энгельс
Yeniyayla için bugünkü hava durumu		погода на сегодня южное бутово
Boztepe için bugünkü hava durumu		погода на сегодняшний день барановка
Çanakkale  için bugünkü hava durumu		погода на сегодняшний день в чебоксарах
bugünkü hava durumunu söyle		погода на сегодняшний день скажи
yedi Ağustos için hava durumu		погода на седьмое августа
Bafra yedi Ağustos için hava durumu		погода на седьмое августа барнаул
Nevşehir  yedi Ağustos için hava durumu		погода на седьмое августа в новосибирске
yedi Temmuz için hava durumu		погода на седьмое июля
yedisi için hava durumu		погода на седьмое число
on yedi Ağustos için hava durumu		погода на семнадцатое августа
iki bin on yedi yılı on yedi Ağustos tarihi için Çorlu'daki hava durumu		погода на семнадцатое августа две тысячи семнадцатого года в челябинске
on yedi Temmuz için hava durumu		погода на семнадцатое июля
on yedi Temmuz için hava durumu yarın on yedisi		погода на семнадцатое июля завтра семнадцатое число
on yedi Temmuz için haftalık hava durumu 		погода на семнадцатое июля по неделям
on yedisi Pazartesi için hava durumu		погода на семнадцатое число понедельник
Bergama'da saat on yedide hava durumu		погода на семнадцать часов в вологде
yedi için hava durumu		погода на семь
yedi günlük için hava durumu		погода на семь дней
Ankara  için yedi günlük hava tahmini		погода на семь дней в москве
Eylül için hava tahmini		погода на сентябрь
Bucak Eylül ayı için hava tahmini		погода на сентябрь в белгороде
Ankara  Eylül için hava tahmini		погода на сентябрь в москве
Nizip Eylül için hava tahmini		погода на сентябрь в нижнем тагиле
Uşak Eylül ayı için hava tahmini		погода на сентябрь в уфе
Adana ili Kozan şehri Eylül için hava tahmini		погода на сентябрь город шуя ивановская область
iki bin on yedi Eylül için hava durumu		погода на сентябрь две тысячи семнадцатого года
Bafra iki bin on yedi Eylül için hava durumu		погода на сентябрь две тысячи семнадцатого года барнаул
Muratlı Tekirdağ Eylül için hava durumu		погода на сентябрь мантурово костромской
Eylül ayı için hava tahmini		погода на сентябрь месяц
Eylül ayı için Orhangazi hava durumu		погода на сентябрь месяц добрянке
Keller Eylül ayı için hava tahmini		погода на сентябрь месяц крымск
Hayrabolu Eylül ayı için hava tahmini		погода на сентябрь месяц нижний новгород
Ankara  Eylül için hava tahmini		погода на сентябрь москве
Uzunköprü Eylül için hava tahmini		погода на сентябрь новый уренгой
Eylül için hava durumu sıcak olsun		погода на сентябрь чтобы было тепло
Eylül ortası için hava durumu		погода на середину сентября
gelecek için hava durumu		погода на след
önümüzdeki saat için hava tahmini		погода на следующей на следующий час
önümüzdeki hafta için hava tahmini		погода на следующей неделе
haftalık hava durumu tamamen göster		погода на следующей неделе полностью покажите
önümüzdeki hafta sonu için hava tahmini		погода на следующие выходные
önümüzdeki Pazartesi için hava tahmini		погода на следующий понедельник
önümüzdeki hafta için hava durumu		погода на следующую неделю
önümüzdeki hafta için Yazıtepe hava durumu		погода на следующую неделю в запорожье
önümüzdeki hafta için Malkara hava durumu		погода на следующую неделю в мордовии
önümüzdeki hafta için Ankara   hava durumu		погода на следующую неделю в москве
önümüzdeki hafta için Süleymanpaşa ilçesi  hava durumu		погода на следующую неделю в сальском районе
önümüzdeki Cuma için hava tahmini 		погода на следующую пятницу
önümüzdeki Cumartesi için hava tahmini 		погода на следующую субботу
Sokutaş'ta hava durumu		погода на соловках
Tunceli Çarşamba için hava durumu		погода на среду в туле
Memişli Çarşamba için hava durumu		погода на среду мыски
Çarşamba ve Perşembe için hava tahmini		погода на среду на четверг
Adana ili Kısacıklı köyü için hava durumu 		погода на станции ксеньевская забайкальского края
Sağkaya'da hava durumu		погода на старкова
Sarımazı'da hava durumu		погода на струнино
Cumartesi için hava tahmini		погода на субботу
Ceyhanbekirli Cumartesi için hava tahmini		погода на субботу в житковичи
Birkent köyü Cumartesi için hava tahmini		погода на субботу в село большой самовец
Terme  Cumartesi için hava tahmini		погода на субботу в тольятти
Cumartesi akşam için hava tahmini		погода на субботу вечером
Fadıl Cumartesi için hava tahmini		погода на субботу витебске
Cumartesi Pazar günleri için Bulancak'de hava durumu		погода на субботу воскресение большой камень
Cumartesi Pazar günleri için hava durumu		погода на субботу воскресенье
Cumartesi Pazar günleri için Karabaş şehrinde hava durumu		погода на субботу воскресенье в городе карабаш
Cumartesi Pazar Pazartesi için hava durumu		погода на субботу воскресенье понедельник
Cumartesi için  Kuşadası'nda hava durumu		погода на субботу камень на оби
Cumartesi için Ankara 'da hava durumu		погода на субботу москве
Çanakkale Boğazı'nda Cumartesi için hava tahmini		погода на субботу на канале ави
Cumartesi on beşi için Kangal şehrinde hava durumu		погода на субботу пятнадцатое число город кустанай
Sarıbahçe'de hava durumu		погода на судоремонте
hava tahmini		погода на счете
Ağustos ayı için Toktamış'ta hava durumu		погода на тамани в августе месяце
Tekirdağ'da hava durumu		погода на тверь
Tuz gölü'nde hava durumu		погода на телецком озере
Tunceli'nde hava durumu		погода на тобольск
Üç Temmuz için hava tahmini		погода на третье июля
saat üç için hava tahmini		погода на три
saat üç için hava tahmini		погода на три
günlük hava tahmini		погода на три дня üç
Muş şehri için üç günlük hava durumu		погода на три дня в городе микунь
Tunceli şehri için üç günlük hava durumu		погода на три дня в городе тобольск
Gerdibi için üç günlük hava durumu		погода на три дня в губкине
Gökçe için üç günlük hava durumu		погода на три дня в гурьевске
Merkezefendi  için üç günlük hava durumu		погода на три дня в липецке
Ankara  için üç günlük hava durumu		погода на три дня в москве
Nevşehir  için üç günlük hava durumu		погода на три дня в новосибирске
Sinop için üç günlük hava durumu		погода на три дня в сочи
Yetimli için üç günlük hava durumu		погода на три дня в ялуторовске
önümüzdeki üç gün için hava tahminini söyler misin, lütfen		погода на три дня вперед скажи пожалуйста
Ankara  bölgesi Çankaya şehri için üç günlük hava durumu		погода на три дня город егорьевск московская область
Zonguldak üç günlük hava tahmini		погода на три дня железноводск
Nallıhan üç günlük hava tahmini		погода на три дня новокузнецк
Sincan üç günlük hava tahmini		погода на три дня станция
Yozgat  üç günlük hava tahmini		погода на три дня ярославль
Kırşehir için üç haftalık hava tahmini		погода на три недели в краснодаре
otuz Ağustos için hava tahmini		погода на тридцатое августа
otuz Ağustos için Büyükmangıt'ta hava durumu		погода на тридцатое августа в балабаново
otuz Temmuz için Posyağbasan'da hava durumu		погода на тридцатое июля в петропавловск камчатском
Sakarya şehri otuz Temmuz için  hava durumu		погода на тридцатое июля город красноярск
otuz Temmuz bin için hava durumu 		погода на тридцатое июля тысяча
otuz günlük hava tahmini		погода на тридцать дней
Trabzon için otuz günlük hava tahmini		погода на тридцать дней в тюмени
otuz bir Ağustos için hava durumu		погода на тридцать первого августа
otuz bir Haziran için hava durumu		погода на тридцать первого июня
otuz bir Ağustos için hava durumu		погода на тридцать первое августа
Kösreli otuz bir Aralık için hava durumu		погода на тридцать первое декабря красноперекопск
otuz bir Temmuz için Giresun'da hava durumu		погода на тридцать первое июля в ростове на дону
otuz Ağustos için hava tanmini		погода на тринадцатое августа
Bucak otuz Ağustos için hava tanmini		погода на тринадцатое августа белгороде
Milas otuz Ağustos için hava tanmini		погода на тринадцатое августа в магнитогорске
Ordu şehri otuz Ağustos için kesin hava tanmini		погода на тринадцатое августа город томск точный прогноз
otuz Temmuz için hava durumu		погода на тринадцатое июля
Ukrayna'da hava durumu		погода на украине
Adana ili Boztahta köyü sokağı havası		погода на улице забайкальский край поселок первомайский
Örendere'de hava durumu		погода на уразова
Kaçkar'da hava durumu		погода на урале
Berit dağı'nda hava durumu		погода на усть тым
sabah için hava durumu		погода на утро
Suluova sabah için hava durumu		погода на утро сургут
Oltu için haftalık hava durumu		погода на учалы на неделю
Şubat için hava tahmini		погода на февраль
Ford için hava durumu		погода на форд
Milas Foreca'da hava tahmini		погода на форега магнитогорск
Karaağaç için hava tahmini		погода на ханты мансийске
Hamdilli için hava durumu		погода на холодной балке
hava lanet olası hava durumu		погода на хуй погода
tüm hafta için hava tahmini		погода на целую неделю
bana Ankara  için tüm haftalık hava durumunu söyle bakalım canım		погода на целую неделю в москве скажи дорогая мне
Tokmanaklı için tüm haftalık hava durumu		погода на целую неделю в талинке
bütün gün için Narlıca'da hava durumu		погода на целый день в нальчике
tüm ay için hava durumu		погода на целый месяц
Kayseri için tüm aylık hava durumu		погода на целый месяц кисловодске
Çondu için hava durumu		погода на чанг
Çürükler için hava durumu		погода на чаны
Çörten için hava durumu		погода на чемале
İmamoğlu Çörten için hava durumu		погода на чемале горный алтай
Karadeniz kıyısı için üç günlük hava durumunu söyle, lütfen		погода на черноморском побережье пожалуйста на три дня
Perşembe için hava durumu		погода на четверг
dört Ağustos için hava tahmini		погода на четвертое августа
Çanakkale şehri dört Ağustos için hava tahmini		погода на четвертое августа город чебоксары
dört Temmuz için hava durumu		погода на четвертое июля
Tokat ili dört beş altı Ağustos için hava durumu		погода на четвертое пятое шестое августа в курганской области
dört Eylül için hava tahmini		погода на четвертое сентября
Uşak ayın dördü için hava durumu		погода на четвертое число уфа
Merkezefendi  için dört günlük hava durumu		погода на четыре дня в липецке
Hacıhasanlı için dört günlük hava durumu		погода на четыре дня в нарткале
on dört günlük hava tahmini		погода на четырнадцать дней
Bafra için on dört günlük hava tahmini		погода на четырнадцать дней в барнауле
Ankara  için on dört günlük hava tahmini		погода на четырнадцать дней в москве
Van için on dört günlük hava tahmini		погода на четырнадцать дней во владимире
Giresun için on dört günlük hava tahmini		погода на четырнадцать дней ростов на дону
Çukurova için hava tahmini		погода на чукотке проведения
Çorlu için hava durumu		погода на чуру
yarın için Çorlu hava durumu		погода на чуру на завтра
İzmir Çandarlı Körfezi'nde hava durumu		погода на шаморе бухта лазурная
on altı Ağustos için Ordu'da hava durumu		погода на шестнадцатое августа в омске
on altı Temmuz için hava durumu		погода на шестнадцатое июля
Sadıkali altı Ağustos için hava durumu		погода на шестого августа в святом власе
Ünye şehri altı Ağustos için hava durumu		погода на шестого августа город уссурийск
altı Ağustos için hava durumu		погода на шестое августа
altı Ağustos için Rize ili  Derepazarı'nda hava durumu		погода на шестое августа в городе донецке ростовской области
altı Ağustos için Terme 'da hava durumu		погода на шестое августа в тольятти
altı Eylül için hava durumu		погода на шестое сентября
altı Eylül için Nevşehir 'de hava durumu		погода на шестое сентября в новосибирске
altısı için hava durumu		погода на шестое число
Alanya şehri saat altı için hava durumu		погода на шесть часов в городе ангарске
Erenler için hava durumu		погода на шира
Sakarya ili Erenler için on Temmuz itibariyle hava durumu		погода на шира красноярский край с десятого июля
cep telefonu ekranında hava durumu		погода на экране смартфона
Ağrı Dağı'nda hava durumu		погода на эльбрусе гора
bu haftada hava durumu		погода на этой неделе
bu hafta için hava durumu		погода на эту неделю
bu hafta Hacıbektaş  için hava durumu		погода на эту неделю в набережных челнах
Pazara kadar bu hafta için hava durumu		погода на эту неделю до воскресенья
bu hafta için hava durumunu söyle bana		погода на эту неделю мне скажи
Yeniyayla için bugünkü hava durumu		погода на южном бутово сегодня
Ya'da hava durumu, soğuk havaya		погода на я погода на холодную
Üçadalar'da hava durumu		погода на ямале
Aydın bölgesi Yenipazar'da hava durumu		погода на яровом в алтайском крае
yarın için Yenipazar'da hava durumu		погода на яровом на завтра
Yatçılık için hava durumu		погода на яхту
Hacıbektaş  hava durumu		погода набережные челны
yarın için Hacıbektaş 'ta hava durumu		погода набережные челны на завтра
bugün için Hacıbektaş'ta hava durumu		погода набережные челны на сегодня
Hizan'вa hava durumu		погода называевске
Hizan ilçesi için aylık hava durumu		погода называевском районе на месяц
Yarın için Honaz'da hava durumu		погода намангане завтра
Nusaybin'de hava durumu		погода наро фоминск
hava durumu bizi kandırıyor		погода нас дурят
Süphan Dağı'nda hava durumu		погода насегодня в шерловой горе
Siirt 'da hava böyle değil		погода не такая саратове
Hocalar'da hava durumu		погода невинномысск
Hatay hava durumu		погода нефтекамск
tüm gün için Hatay'da hava durumu		погода нефтекамске на целый день
Hanımın Çiftliği hava durumu		погода нефтеюганск
Hopa hava durumu		погода нижневартовск
Hatay hava durumu		погода нижнекамск
Hatay hava durumu nedir?		погода нижнекамск какая сегодня
Hayrabolu hava durumu		погода нижний
Hayrabolu hava durumu		погода нижний новгород
yarın Hayrabolu hava durumu		погода нижний новгород завтра
yarın için Hayrabolu hava durumu		погода нижний новгород на завтра
Hayrabolu aylık  hava durumu		погода нижний новгород на месяц
Hayrabolu haftalık hava durumu		погода нижний новгород на неделю
Hayrabolu bugünkü hava durumu		погода нижний новгород сегодня
Nizip hava durumu		погода нижний тагил
Nizip haftalık hava durumu		погода нижний тагил на неделю
Horasan hava durumu		погода нижний удинск
Hilvan haftalık hava durumu		погода нижний услон на неделю
Horasan hava durumu		погода нижний цасучей
Alt katta hava durumu		погода нижний этаж
Tekirdağ ili Hayrabolu hava durumu		погода нижняя ермоловка кчр
Vezirköprü ilçesi Mezra hava durumu		погода николаевск волгоградская область
Vezirköprü Mezra hava durumu		погода николаевск волгоградской
Vezirköprü ilçesi Mezra hava durumu		погода никольск вологодская область
Nice hava durumu		погода ницца
Nurhak hava durumu		погода новая игирма
Kahramanmaraş ili  Onikişubat şehri hava durumu		погода новгородская область город окуловка
Ağrı hava durumu		погода новоалександровск
Narlıören  yarın için hava durumu		погода новоаннинский на завтра
Orhangazi hava durumu		погода новобелокатай
Niğde için üç günlük hava durumu		погода новозыбков на три дня
Nurdağı hava durumu		погода новокубанск
Karapürçek hava durumu		погода новокузнецк
Karapürçek iki haftalık hava durumu		погода новокузнецк на две недели
Karapürçek aylık hava durumu		погода новокузнецк на месяц
Karapürçek bugünkü hava durumu		погода новокузнецк на сегодня
Karapürçek hava durumu		погода новокузнецкая
Narlıca hava durumu		погода новокуйбышевск
Kırşehir ili Akçakent hava durumu		погода новомихайловке краснодарский край
Kırşehir Akçakent hava durumu		погода новомихайловское краснодар
Uzunköprü hava durumu		погода новый уренгой
Uzunköprü yarın için hava durumu		погода новый уренгой на завтра
Uzunköprü bugünkü hava durumu		погода новый уренгой сегодня
Niğde hava durumu		погода норильск
Gece hava durumu Alisa		погода ночи алиса
Gece hava durumu bebeğim		погода ночь крошка
gece hava durumu		погода ночью
Battalgazi'de gece hava durumu		погода ночью в баймаке
Göksun'da gece hava durumu		погода ночью в гомеле
Emirdağ'da gece hava durumu		погода ночью в емельяново
İzmit gece hava durumu		погода ночью в ижевске
Muradiye'de gece hava durumu		погода ночью в майкопе
Malatya'da gece hava durumu		погода ночью в махачкале
Muratlı'da gece hava durumu		погода ночью в моздоке
Yozgat'ta gece hava durumu		погода ночью в ярославле
on altı Ağustos gecesi hava durumu		погода ночью шестнадцатого августа
Harbiye hava durumu		погода нурлат
on bir Ağustos hava durumu		погода одиннадцатого августа
Giresun 'ta on bir Temmuz hava durumu		погода одиннадцатого июля в горно алтайске
on bir Temmuz on iki Temmuz hava durumu		погода одиннадцатого июля двенадцатого июля
Oltu hava durumu		погода одинцово
Ankara  bölgesi Oltu hava durumu		погода одинцово московская область
Oltu bugünkü hava durumu		погода одинцово сегодня
yirmi dördü için Karadeniz bölgesi   Of için hava durumu		погода озерное приморский край на двадцать четвертое
Of hava durumu 		погода озеры
Çorlu şehri iki bin on yedi yılın Ekim ayı için hava durumu		погода октябрь две тысячи семнадцатый год город челябинск
Bandırma   hava durumu		погода октябрьский
Oba hava durumu		погода окуловка
Ordu hava durumu		погода омск
Ordu on bir hava durumu		погода омск одиннадцать
Ordu şu anki hava durumu		погода омск сейчас
Ordu bölgesi hava durumu		погода омская область
Tavşanlı'da hava durumu online		погода онлайн в воронеже
Soma'da hava durumu online		погода онлайн в семилуках
İzmir bölgesinde hava durumu haritada		погода онлайн на карте иркутской области
Soma hava durumu online		погода онлайн семилуках
Osmaneli hava durumu		погода ордынское
Ödemiş hava durumu		погода орел
Ordu için yarına hava durumu		погода оренбург завтрашний день
Ordu anlık hava durumu		погода оренбург сейчас
Ordu İli Çatalpınar hava durumu		погода оренбургская область пономаревский
Odabaşı hava durumu		погода орехово зуево
Orduzu hava durumu		погода оршанка
Malatya'da sonbahar hava durumu		погода осенью в махачкале
Büyükada iki haftalık hava durumu		погода остров попов на две недели
Phuket adası hava durumu		погода остров пхукет
Umurlu adası hava durumu		погода остров укатный
Hainan Sanya adası hava durumu		погода остров хайнань санья
ölüm havası		погода от смерти
Ortaklar hava durumu		погода ош
Pınarhisar hava durumu		погода павловск
Pınarhisar için aylık hava durumu mgm 		погода павловская рп пять на месяц
Pelitli hava durumu		погода параплан
Pazar yarın hava durumu		погода парголово завтра
Pazarcık hava durumu		погода партизанск
Yozgat  için hava durumu rüzgarlı		погода пгт ярославский ветерком
Pencikent hava durumu		погода пенджикент
Pamukova hava durumu		погода пенза
Sakarya ili Pamukova ilçesi hava durumu		погода пензенская область никольский район
Tekirdağ ili Hayrabolu hava durumu		погода пено тверской области
bir Ağustos için hava durumu		погода первого августа
Ardeşen'de bir Ağustos için hava durumu		погода первого августа в в алуште
Göksun'da bir Ağustos için hava durumu		погода первого августа в гомеле
Nevşehir 'ta bir Ağustos için hava durumu		погода первого августа в новосибирске
İstanbul  bir Ağustos için hava durumu		погода первого августа санкт петербург
bir Eylül hava durumu		погода первого сентября
Alaşehir'de bir Eylül hava durumu		погода первого сентября в ардатове
Malatya'da bir Eylül hava durumu		погода первого сентября в махачкале
Ödemiş'te bir Eylül hava durumu		погода первого сентября в орле
Tunceli'nda bir Eylül hava durumu		погода первого сентября в туле
Uşak'ta bir Eylül hava durumu		погода первое сентября уфа
Derinkuyu hava durumu		погода первоуральск
yarın için Derinkuyu hava durumu		погода первоуральск на завтра
hafta sonları hava durumunu		погода передышек недели
Erdemli Tömük hava durumu		погода пересыпь темрюкский
Bayburt  ili için hava durumu		погода пермский край
Bayburt  ili Aydıntepe  ilçesi Sırataşlar köyü hava durumu		погода пермский край октябрьский район поселок щучье озеро
Bayburt  hava durumu		погода пермь
Bayburt iki günlük hava durumu		погода пермь два дня
Bayburt  on günlük hava durumu		погода пермь на десять дней
Bayburt  anlık hava durumu		погода пермь сейчас
Bayat hava durumu		погода пестово
Bozkurt hava durumu		погода пестяки
İstanbul hava durumu		погода петергоф
Ballıca hava durumu		погода петриковка
Boyabat Alibeyli hava durumu		погода петровск забайкальск
Boyabat Alibeyli hava durumu		погода петровск забайкальский
yarın için Siirt  ili Pervari hava durumu		погода петровск саратовской области на завтра
Bilecik hava durumu		погода петрозаводск
Posyağbasan hava durumu		погода петропавловска камчатского
Aladağ ilçesi Posyağbasan köyü hava durumu		погода петропавловский район село камышенка
Niğde ili Bor hava durumu		погода пильна нижегородской области
Hanönü Yukarıçakırçay  hava durumu		погода пионерск балтийск рыбачий
İstanbul hava durumu		погода питер
İstanbul bugünkü hava durumu		погода питер на сегодня
Bağdere hava durumu		погода плоскошь
Cumartesi için günün zamanına göre hava durumu		погода по времени суток на субботу
Samsun ili Terme şehri için hava durumu		погода по городу туринска свердловской области
Kumru için haftalık hava durumu		погода по кушве на неделю
Kıbrıs için aylık hava durumu		погода по месяцам на кипре
bölgeye göre hava durumu		погода по области
İzmir ili hava durumu		погода по области иркутск
İstanbul  bölgesi için hava durumu		погода по область санкт петербурга
Silopi ilçesi hava durumu		погода по самарской области
Tavas'ta tüm Ağustos için hava durumu		погода по таловой на весь август
saatlik hava durumu		погода по часам
yarın için Ankara'da saatlik hava durumu		погода по часам в москве на завтра
Tekirdağ'da bugün için saatlik hava durumu		погода по часам в твери на сегодня
İzmir'de bugün için saatlik hava durumu		погода по часам на сегодня в иркутске
Bafra şehri bugün için saatlik hava durumu		погода по часам на сегодня город барнаул
Nevşehir saatlik hava durumu		погода по часам новосибирск
Yeşilli şehri için bugünkü hava durumu		погода погода в городе в ейске на сегодня
yarın için Narlıören  şehrinde hava durumu		погода погода в городе новоаннинском на завтра
İncirliova'da hava durumu		погода погода в ирбите
sonunda hava durumu		погода погода в конце
Hayrabolu'da hava durumu		погода погода в нижнем новгороде
Ordu'da hava durumu		погода погода в омске
Ankara  Tavşanlı hava durumu		погода погода москва воронеж
yarın için Lice'de hava durumu		погода погода на завтра в лофицкая
haftalık haha durumu		погода погода на неделю
Akdeniz bölgesinde haftalık hava durumu		погода погода на неделю в амурской области
Narlıören'de bugünkü hava durumu		погода погода на сегодня в городе новоаннинском
günlük hava durumu		погода погода на три дня üç
Nadejda Yegorovna hava durumunu bulabilir		погода погода надежда егоровна можно найти
hava durumu hava durumu hava durumu hava durumu		погода погода погода погода
Marmara Bölgesi Erikli kasabası pazar için hava tahmini		погода погода поселок боровой карелия на воскресенье
Pınarbaşı  hava durumu		погода подгоренский
Seydişehir'deki hava durumu lütfen		погода пожалуйста в симферополе
saatlik hava durumu		погода пока часовой
Biga ilçesi yarın için hava durumunu göster		погода покажи на завтра балахтинском районе
Batman bugün için saatlik hava durumu		погода полевской каждый час сегодня
Perşembe hava durumu		погода полоски
Ordu ili İkizce hava durumu		погода полтавка омская область
Bolvadin hava durumu		погода полярные зори
yarın Bolvadin hava durumu		погода полярные зори завтра
bugün Bolvadin hava durumu		погода полярные зори сегодня
hava durumu İstanbul  için bul		погода поменять на санкт петербург
Karapürçek Pazartesi hava durumu		погода понедельник новокузнецк
Burhaniye ilçesi Sübeylidere hava durumu		погода порецкий район степное коровино
doğu Gümüşhane  limanı hava durumu		погода порт восточный находка
Kafkas limanı aylık hava durumu		погода порт кавказ на месяц
Kafkas limanı vapur geçidi hava durumu		погода порт кавказ паромная переправа
kasaba hava durumu		погода поселок
Erdek kasabası hava durumu		погода поселок агинское
Babakale kasabası yarın için hava durumu		погода поселок берегаево на завтра
Fıstıklı kasabası bugünkü hava durumu		погода поселок витязево на сегодня
İzmir ili Ildır kasabası hava durumu		погода поселок залари иркутская область
Filyos kasabası hava durumu		погода поселок зимовники
Doğanbey  kasabası hava durumu		погода поселок имени докучаева
Mürefte kasabası hava durumu		погода поселок лазаревское
Kırşehir ili Dulkadirli  kasabası hava durumu		погода поселок лермонтово краснодарский край
Kırşehir ili Demirli kasabası hava durumu		погода поселок лиманский краснодарский край
Mordoğan kasabası hava durumu		погода поселок магистральный
İzmir ili Mordoğan kasabası hava durumu		погода поселок магистральный иркутская область
İzmir ili Mordoğan kasabası bugünkü hava durumu		погода поселок магистральный иркутская область на сегодня
Ordu İli Perşembe kasabası hava durumu		погода поселок первомайский оренбургской области
Bademli kasabası hava durumu		погода поселок плеханово
Badavut kasabası hava durumu		погода поселок преображение
Palamutbükü kasabası hava durumu		погода поселок пятигорский
yarın için Süphandere kasabası  hava durumu		погода поселок седово на завтра
yirmi dört Ağustos için Sokakağzı kasabası hava durumu		погода поселок солнечный на двадцать четвертое августа
Ordu Akkuş ilçesi Salman Kasabası hava durumu		погода поселок степной ташлинский район оренбургской
Hatay Samandağ kasabası hava durumu		погода поселок сулак дагестан
Taşucu kasabası bugünkü hava durumu		погода поселок тура сегодня
Üçağız kasabası hava durumu		погода поселок усть ордынский
Tunceli ilçesi Kalan kasabası hava durumu		погода поселок чернь тульская область
öğleden sonraki hava durumu		погода после обеда
Akyaka'da öğleden sonraki hava durumu		погода после обеда в алатыре
Güzelçamlı'da öğleden sonraki hava durumu		погода после обеда в голышманово
Gümüşhane'de yarından sonraki hava durumu		погода послезавтра в голицыно
Yozgat'ta Tekirdağ'da yarından sonraki hava durumu		погода послезавтра в ярославле в костроме
Kaş yarından sonraki hava durumu		погода послезавтра киев
saatlik hava durumu		погода почасам
Türkiye Besni hava durumu		погода почеп россия
Badavut hava durumu		погода преображение
sekiz Ağustos Badavut hava durumu		погода преображение восьмого августа
on Ağustos Badavut hava durumu		погода преображение десятое августа
Marmara bölgesi  Badavut hava durumu		погода преображение приморский край
Karadeniz bölgesi  Seydiler iki haftalık hava durumu		погода приморский край славянка на две недели
Karadeniz bölgesi Çatalzeytin hava durumu		погода приморский край чугуевка
Karadeniz bölgesi Akkuş hava durumu		погода приморско ахтарск
Karadeniz bölgesi Ağva kasabası haftalık hava durumu		погода приморском крае пгт ольга на неделю
Bekilli on günlük hava durumu		погода приютово на десять дней
Çivril'de hava durumu kaçta		погода прогноз в сводном во сколько
Pekmezli hava durumu		погода прокопьевск
gün uzunluğu hava durumu		погода протяженность дня
Piraziz hava durumu		погода псков
yarın için Piraziz hava durumu		погода псков на завтра
Piraziz hava durumu yüklenmiyor		погода псков не скачивается
Piraziz hava durumu  bugün		погода псков сегодня
Piraziz'de gündüz hava durumu		погода пскове днем
Piraziz ilçesinde hava durumu		погода псковской области
Büyükçat hava durumu		погода пустошка
Beşaslan hava durumu		погода пучеж
Batıayrancı hava durumu		погода пяндж
Patnos haftalık hava durumu		погода пятигорск на неделю
on beş Ağustos için Ordu'da hava durumu 		погода пятнадцатого августа в омске
on beş Temmuz için Alaşehir'de hava durumu		погода пятнадцатого июля в ардатове
Kırcaoğlu on beşi için hava durumu		погода пятнадцатого числа красная
Kahramanmaraş beş Ağustos için hava durumu		погода пятого августа казань
elli beş hava durumu		погода пятьдесят
yarın için Reşatlı hava durumu		погода радовицкий мох на завтра
Çanakkale hava durumu		погода радужный хмао
Erzin ilçesi Turunçlu hava durumu		погода разнежье воротынский район
Reyhanlı hava durumu		погода раменский
Reyhanlı ilçesi için hava durumu nasıl		погода раменский район как
Reyhanlı hava durumu		погода раменское
Samsun ili Havza hava durumu		погода рассоха свердловская область
Dernekpazarı hava durumu		погода рахманово
Polonya Reda yarın için hava durumu		погода реда польша на завтра
Roma hava durumu 		погода рим со мной
Reece hava durumu		погода рис
Düzköy hava durumu		погода ровеньки на
Durağan hava durumu		погода родино
Dikmen hava durumu		погода родниковый
Derepazarı hava durumu		погода россошь
Rize hava durumu		погода ростов великий
Giresun hava durumu		погода ростов на дону
bugün için Giresun hava durumu		погода ростов на дону на сегодня
Giresun hava durumu		погода ростове на дону
Rize ili Önder mahallesi hava durumu		погода ростовская область хутор гринев
Araban hava durumu		погода рощино
Gazientep ili Araban aylık hava durumu		погода рощино ленинградская область на месяц
mgm hava durumu		погода рп пять
Kayaören hava durumu		погода румянцево
Karacabey ilçesi hava durumu		погода рутульском районе
Serdivan  rezervuarı hava durumu		погода рыбинское водохранилище
sizin yanınızda yanlış bit şeyler oluyor younet hava durumu		погода рядом с вами что то пошло не так юнет
Karaman hava durumu		погода рязань
Karaman hava durumu Karaman'da hava durumu		погода рязань погода в рязани
Doğankent'ten hava durumu		погода с дашковки
yirmi üçünden yirmi beş Ağustusa kadar hava durumu 		погода с двадцать третьего по двадцать пятое августа
yirmi dört Hazirandan sonraki hava durumu		погода с двадцать четвертого июня
yirmi altı Temmuzdan otuz bir Temmuza kadar hava durumu		погода с двадцать шестого июля по тридцать первое июля
onundan otuzuna kadarAyranpınar köyünde hava durumu		погода с десятого по тринадцатое в селе андреевка
bir Ağustos'dan hava durumu		погода с первого августа до
birden on Ağustos'a kadar Samara'da hava durumu		погода с первого по десятое августа самара
Pazartesinden başlayan hava durumu		погода с понедельника
arşambadan Perşembeye kadar hava durumu		погода с среды по четверг
Adana ili Yüreğir ilçesi Sağdıçlı hava durumu		погода сазоново чагодощенский район вологодская область
Çilimli hava durumu mgm sitesi		погода сайт рп пять черниговка
Sütlüce hava durumu		погода саки
Silifke hava durumu		погода салават
Seydiler hava durumu		погода салехард на воде
Şiran hava durumu		погода салым
Silopi hava durumu		погода самара
yarın için Silopi hava durumu		погода самара на завтра
bugün için Silopi hava durumu		погода самара на сегодня
Samarkand hava durumu		погода самарканд
Silopi ilçesi hava durumu		погода самарская
Silopi ilçesi Birlikköy köyü hava durumu		погода самарская область село бузаевка
İstanbul  hava durumu		погода санкт петербург
Avcılar İstanbul  hava durumu		погода санкт петербург агалатово
Temmuz ayı için İstanbul  hava durumu		погода санкт петербург в июле месяце
on Ağustos için İstanbul  hava durumu		погода санкт петербург десятое августа
yarın İstanbul  hava durumu		погода санкт петербург завтра
yarın için İstanbul  hava durumu		погода санкт петербург на завтра
bugün için İstanbul  hava durumu		погода санкт петербург на сегодня
İstanbul Sarıyer hava durumu 		погода санкт петербург пулково два
bugünkü İstanbul  hava durumu		погода санкт петербург сегодня
İstanbul  hava durumu		погода санкт петербурга
İstanbul'da hava durumu		погода санкт петербурге
İstanbul  haftalık hava durumu		погода санкт петербурге на неделю
İstanbul  üç günlük hava durumu		погода санкт петербурге на три дня
İstanbul'da bugün hava durumu		погода санкт петербурге сегодня
Sandıklı hava durumu		погода сарагаш
Simav hava durumu		погода саранск
Siirt hava durumu		погода саратов
Siirt ayrıntılı hava durumu		погода саратов подробно
Siirt ili Eruh hava durumu		погода саратовская область новобурасский
Şarkışla hava durumu		погода саргашы
Kazakistan Sarıkol hava durumu		погода сарыколь казахстан
Şemdinli yedi günlük hava durumu 		погода сафакулево на семь дней
Safari Park hava durumu		погода сафари парк
Yalova Fıstıklı kasabası haftalık hava durumu		погода саха якутия поселок чернышевский на неделю
Sarıkamış hava durumu		погода сахалинске
Söke hava durumu		погода саяногорск
Samsun hava durumu		погода свердловская
on yedi yılın yirmi beş Ağustos Sarıkaya hava durumu		погода светлогорск двадцать пятое августа семнадцатого года
Sarıkaya bugünkü hava durumu		погода светлогорск на сегодня
Sarıbey yarın için hava durumu		погода светлополянск на завтра
Solhan hava durumu		погода севастополь
yarın Solhan hava durumu		погода севастополь завтра
yarın için Solhan hava durumu		погода севастополь на завтра
Nevşehir ilinin kuzeyi için bugünkü hava durumu		погода северное новосибирской области сегодня на весь день
Saruhanlı hava durumu		погода северобайкальск
yarın için Severodvinsk hava durumu		погода северодвинск на завтра
Sürmene üç bugünkü hava durumu		погода североморск три на сегодня
Anamur ilçesinde bugün hava durumu		погода сегодня в аксайский район
Antalya'da bugün hava durumu		погода сегодня в анапе
Akkülek'te  bugün hava durumu		погода сегодня в артеме
Bitlis'te bugün hava durumu		погода сегодня в балаково
Birecik'te bugün hava durumu		погода сегодня в барабинске
Bucak'ta  bugün hava durumu		погода сегодня в белгороде
Biga'da  bugün hava durumu		погода сегодня в бердске
Bandırma'da  bugün hava durumu		погода сегодня в бородино
sekiz yüzde bugün hava durumu		погода сегодня в восьмистах
Başçiftlik şehrinde bugün hava durumu		погода сегодня в городе владивосток
İnebolu şehrinde bugün hava durumu		погода сегодня в городе иваново
Düziçi 'da bugün hava durumu		погода сегодня в давлеканово
Dereli'de bugün hava durumu		погода сегодня в добрянке
Donetsk'ta bugün hava durumu		погода сегодня в донецке
Evpatorya'da bugün hava durumu 		погода сегодня в евпатории
Zara'da bugün hava durumu		погода сегодня в зеленодольске
İnebolu'da bugün hava durumu		погода сегодня в иваново
İzmit'te bugün hava durumu		погода сегодня в ижевске
İzmit'te bugün hava durumu		погода сегодня в киеве возле
İzmit'te bugün hava durumu		погода сегодня в клинцах
İzmit'te bugün hava durumu		погода сегодня в кондрове
Kabadüz'de bugün hava durumu		погода сегодня в красноармейске
Kırşehir'de bugün hava durumu		погода сегодня в краснодаре
Kırşehir'de Sakarya'da  bugün hava durumu		погода сегодня в краснодаре в красноярске
Koramanlar'da bugün hava durumu		погода сегодня в кунгуре
Milas'ta bugün hava durumu nasıl?		погода сегодня в можайске какая
Ankara 'da bugün hava durumu		погода сегодня в москве
Hayrat'ta bugün hava durumu		погода сегодня в нестерове
Nevşehir'de bugün hava durumu		погода сегодня в новосибирске
Ordu'da bugün hava durumu		погода сегодня в омске
Pekin'de bugün hava durumu		погода сегодня в пекине
Pamukova'da bugün hava durumu		погода сегодня в пензе
Bayburt'ta bugün hava durumu		погода сегодня в перми
İstanbul'da bugün hava durumu		погода сегодня в петербурге
Pazar'da bugün hava durumu		погода сегодня в пугачеве
Patnos'ta bugün hava durumu		погода сегодня в пятигорске
Giresun'da bugün hava durumu		погода сегодня в ростове на дону
Akdeniz bölgesi Silifke'de bugün hava durumu		погода сегодня в салавате башкирия
İstanbul 'da bugün hava durumu		погода сегодня в санкт петербурге
 Sincan'da bugün hava durumu		погода сегодня в сергиев посаде
Seydişehir'de bugün hava durumu		погода сегодня в симферополе
Sinop'ta bugün hava durumu		погода сегодня в сочи
Sinop Ayancık'ta bugün hava durumu		погода сегодня в сочи адлер
Düziçi'nde bugün hava durumu		погода сегодня в спасске
Suluova'da bugün hava durumu		погода сегодня в сургуте
Terme'de bugün hava durumu		погода сегодня в тольятти
Ordu'da bugün hava durumu		погода сегодня в томске
Tandır'da bugün hava durumu		погода сегодня в туже
Uşak'ta bugün hava durumu		погода сегодня в уфе
Çorlu'da bugün hava durumu		погода сегодня в челябинске
Şabanözü'nde bugün hava durumu		погода сегодня в шахтах
bugün akşam hava durumu		погода сегодня вечер
bugün akşamlayın hava durumu		погода сегодня вечером
Başçiftlik bugün hava durumu		погода сегодня владивосток
Başçiftlik'te bugün hava durumu		погода сегодня владивостоке
Başçiftlik'te bugün hava durumu		погода сегодня во владивостоке
Siirt şehrinde bugün hava durumu		погода сегодня город саратов
bugün  gündüz hava durumu		погода сегодня днем
Bafra'da bugün yarın hava durumu		погода сегодня завтра в барнауле
Çorlu'da bugün hava durumu nasıl olacak?		погода сегодня какая будет в челябинске
bugün hava durumu iyi mi kötü mü?		погода сегодня какая хорошая или плохая
Ankara  bugün hava durumu		погода сегодня москва
bugün yarın için hava durumu		погода сегодня на завтра
Ünye için bugünkü hava durumu		погода сегодня на уссурийск
Karapürçek bugün hava durumu		погода сегодня новокузнецк
Nazilli bugün hava durumu		погода сегодня новороссийск
bugün gece hava durumu		погода сегодня ночь
bugün gece için hava durumu		погода сегодня ночью
Ünye'de bugün gece hava durumu		погода сегодня ночью в уссурийске
bugün gece ve yarın sabah için hava durumu		погода сегодня ночью завтра утром
bugün saatlik hava durumu		погода сегодня по часам
bugün öğleden sonra hava durumu		погода сегодня после обеда
Bucak ilçesi Gündoğdu bugün hava durumu		погода сегодня ракитное белгородской области
Giresun bugün hava durumu		погода сегодня ростов на дону
İstanbul  bugün hava durumu		погода сегодня санкт петербург
Saray bugün hava durumu		погода сегодня сарапул
Ürkütlü bugün hava durumunu söyle		погода сегодня усть долыссы
Şabanözü bugün hava durumu 		погода сегодня шахты
bugünkü akşam hava durumu		погода сегодняшняя дня вечером
Süphandere haftalık hava durumu		погода седово на неделю
Bolu şu an hava durumu		погода сейчас буденовск
Avdancık'ta şu an hava durumu		погода сейчас в аниве
Van'da şu an hava durumu		погода сейчас в владимере как ее
şehirde şu an hava durumu		погода сейчас в городе
Dörtyol 'te şu an hava durumu		погода сейчас в дербенте
Küre'de şu an hava durumu		погода сейчас в коломне
Kırşehir'de şu an hava durumu		погода сейчас в краснодаре
Muğla'da şu an hava durumu		погода сейчас в медыне
Hayrabolu'da şu an hava durumu		погода сейчас в нижнем новгороде
Ödemiş'te şu an hava durumu		погода сейчас в орле
Patnos'ta şu an hava durumu		погода сейчас в пятигорске
Karaman'da şu an hava durumu		погода сейчас в рязани
Suluova'da şu an hava durumu		погода сейчас в сургуте
Uşak'ta şu an hava durumu		погода сейчас в уфе
Çanakkale 'da şu an hava durumu		погода сейчас в чебоксарах
Çal'da şu an hava durumu		погода сейчас в шатуре
Güney'de şu an hava durumu		погода сейчас глазов
Kırıkhan şu an hava durumu		погода сейчас каменск
Manavgat hava durumu		погода села музаим
Kırşehir ili Aydınlar köyü hava durumu		погода село агой краснодарский край
Bayındır köyü hava durumu		погода село бердюжье
Babur köyü hava durumu		погода село болонь
Bucak ilçesi Beşkonak köyü hava durumu		погода село большое белгородская области
Bahçepınar köyü hava durumu		погода село буйское
Gültepe köyü hava durumu		погода село гусевка
Dedeli köyü hava durumu		погода село донское
Ordu İli Bulut köyü hava durumu		погода село илек оренбургской области
İkizler köyü hava durumu		погода село ильинка
Kabaklı köyü hava durumu		погода село курджиново
Turhal ilçesi Hamide köyü hava durumu		погода село лермонтово туапсинский район
Mollaosmanlar köyü hava durumu		погода село москвитина
Üzümlübel köyü hava durumu		погода село овощи
Ordu ili Düzköy köyü hava durumu		погода село одесское омской области
Albastı ilçesi Alacalar köyü hava durumu		погода село садовое нижнегорский район
Denizli ili Buldan ilçesi Alandız Köyü yarın için hava durumu		погода село соленое займище астраханская область на завтра
Seyfe köyü bugünkü hava durumu		погода село соленое займище сегодня
Samsun ili Kabadüz köyü hava durumu		погода село стародубское ставропольский край
Susuz köyü haftalık hava durumu		погода село судай на неделю
Sakarya ili Kayrancık köyü hava durumu		погода село сухобузимское красноярский край
beş Temmuz için Hamidiye köyü hava durumu		погода село тетюшское на пятое июля
Eşrefli köyü hava durumu		погода село фащевка на неделю
Acıpayam ilçesi Yeşildere köyü hava durumu		погода село ясная поляна анучинский район
on yedisi hava durumu		погода семнадцатого
on yedi Temmuz hava durumu		погода семнадцатого июля
Kırşehir on yedi Temmuz hava durumu		погода семнадцатое июля краснодар
Eylül hava durumu		погода сентябрь
Antalya Eylül hava durumu		погода сентябрь анапа
Eylül ayı hava durumu, lütfen		погода сентябрь месяц пожалуйста
Sırçalık hava durumu		погода сергач
iki Ağustos sabah Sergach hava durumu		погода сергачи утром второго августа
Sincan hava durumu		погода сергиев посад
bugün Ankara  bölgesi  Sincan hava durumu		погода сергиев посад московская область сегодня
Sarıömerli hava durumu		погода сердобск
Samandağ  hava durumu		погода серпухов
yarın için Suçatı hava durumu 		погода сестрорецк на завтра
Zeytinburnu hava durumu 		погода сибирский тракт
Samandıra hava durumu		погода сибирь
Bayburt ili Aydıntepe hava durumu		погода сива пермский край
Gazientep ili Yavuzeli ilçesi Yeniyurt bugünkü hava durumu		погода сиверский сегодня ленинградская область гатчинский район
Sandıklı hava durumu		погода симеиз
Seydişehir hava durumu		погода симферополь
yarin için Sarayköy hava durumu		погода сингапай на завтра
hava tahmini		погода синоптик
Hava durumunu söyle Bahçe Paşabahçe		погода скажи покровка деревянный покровка
Solakuşağı hava durumu		погода скопин
Sarılar hava durumu		погода скоропуха
Sarıgöl hava durumu		погода славгород
Sarıgöl hava durumu on dört gün için 		погода славгород на четырнадцать дней
yarın Side hava durumu		погода славск завтра
Oğuzeli Sergili hava durumu		погода славянск на кубани
önümüzdeki Cumertesine hava durumu		погода следующую субботу
Soma hava durumu		погода служанок
Sorgun hava durumu		погода слуцк
hava durumunu söyleyebilir misin		погода смит можешь
Silvan hava durumu		погода смоленск
yarın için Silvan hava durumu		погода смоленск на завтра
Silvan bölgesi Khislavichsky ilçesi köyü hava durumu ve hakkında görüş		погода смоленская область хиславичский район деревня и отзыв к
bugüb Silvan hava durumu		погода смоленская сегодня
Sancaktepe hava durumu		погода смольный
Çorlu ilçesi Şehbaz hava durumu		погода снежинск челябинская область
Çorlu ilçesi Şehbaz hava durumu		погода снежинск челябинской области
Seydiler hava durumu		погода советск
Seydiler Ercek hava durumu		погода советское руно
Silivri hava durumu		погода сокол
Sultangazi hava durumu		погода соленое займище
Şile hava durumu		погода соликамск
Şişli hava durumu		погода солонцы
Serinyol hava durumu		погода сорочий лог
Suşehri hava durumu		погода сосенский
yarın Söğüt hava durumu		погода сосновоборск завтра
Sinop hava durumu		погода сочи
yarın için Sinop hava durumu		погода сочи на завтра
aylık Sinop hava durumu		погода сочи на месяц
yedi Eylül için Sinop hava durumu		погода сочи на седьмое сентября
Düziçi hava durumu		погода спасск рязанский
bugün Düziçi hava durumu		погода спасск рязанский сегодня
İstanbul  hava durumu		погода спб
İstanbul  hava durumu beş		погода спб пять
Seymen hava durumu		погода ставрово
Samsun hava durumu		погода ставрополь
yarın Samsun hava durumu		погода ставрополь завтра
bugün için Samsun hava durumu		погода ставрополь на сегодня
Göle köyü haftalık hava durumu		погода станица голубицкая на неделю
Kırşehir ili Ömerhacılı  mahallesi hava durumu		погода станица должанская краснодарский край
Kırşehir ili Kurancılı mahallesi hava durumu		погода станица костромская краснодарский край
bir günlük mahalle hava durumu		погода станицы на один
Narlı kasabası hava durumu		погода станицы надежной
Akdeniz bölgesi Finike mahallaesi hava durumu		погода станция поздеевка амурская область на неделю
yarın için Samandağ hava durumu		погода старая русса на завтра
Şehbaz hava durumu		погода старобалтачево
Seydiler ilçesi Sabuncular on günlük hava durumu		погода степное советский район на десять дней
yarın için Suruç  hava durumu		погода стерлитамак на завтра
Sürmene hava durumu		погода ступино
Cumartesine hava durumu		погода субботу
Söke ilçesi hava durumu		погода сузумского района
Sarılar hava durumu 		погода сузун
beş Ağustos için Safranbolu hava durumu		погода суксун на пятое августа
yarın için Suluova ilçesi Akören hava durumu		погода сулейман стальском районе на завтра
bugün için Seymen hava durumu		погода сумы на сегодня
Serinhisar için bugünkü hava durumu		погода сумы сегодня
Suluova hava durumu		погода сургут
yarın için Serik hava durumu		погода сызрань на завтра
Seben hava durumu		погода сыктывкар
Cuma Cumartesi Pazar için Seben hava durumu		погода сыктывкаре на пятницу субботу воскресенье
Tacik hava durumu		погода таджик
Tacikistan hava durumu		погода таджикистан
Tacikistan şehri hava durumu		погода таджикистан город
Tacikistan İsfara şehri hava durumu		погода таджикистан город исфара
Tacikistan Yovon şehri hava durumu		погода таджикистан город яван
Tacikistan Duşanbe hava durumu		погода таджикистан душанбе
Tacikistan İstaravshan hava durumu		погода таджикистан истаравшан
Tacikistan Kano hava durumu		погода таджикистан кано потом
Tacikistan Kolkhozabad hava durumu		погода таджикистан колхозабад
Tacikistan Kurgan Tube hava durumu		погода таджикистан курган тюбе
şu an Tacikistan hava durumu		погода таджикистан сейчас
Tacikistan Khatlon bölgesi hava durumu		погода таджикистан хатлонская область
Tacikistan Khudjand hava durumu		погода таджикистан худжанд
Tacikistan Chili Chor Chashma hava durumu		погода таджикистан чили чор чашма
Tacikistan Şaartuz hava durumu		погода таджикистан шахритуз
Tacikistan hava durumu		погода таджикистана
Taylandlılar hava durumu		погода тайцы
Taşova hava durumu		погода талица
Ağustos için Türkgücü hava durumu		погода таловая на август
Turgutlu hava durumu		погода тамбов
yarın Turgutlu hava durumu		погода тамбов завтра
bugün için Turgutlu hava durumu		погода тамбов на сегодня
Ordu ili Taşlıçay hava durumu		погода тара омская область
Turnasuyu hava durumu		погода тарко сале
Hatay Belen hava durumu		погода тарумовка республика дагестан
İç Anadolu Bölgesi Kahramanmaraş hava durumu		погода татарстане казань
Taşkent hava durumu		погода ташкент
 Tekirdağ hava durumu		погода тверь
Cumartesi sabah Tekirdağ'da hava durumu		погода тверь днем суббота
Tuazak hava durumu		погода темиргоевская
Taşoluk iki haftalık hava durumu		погода терек на две недели
Tefenni hava durumu		погода тетюши
Topçam hava durumu		погода тимашевск
yarın için Tatvan hava durumu		погода тихвин на завтра
Tunceli hava durumu		погода тобольск
Tunceli için üç günlük hava durumu		погода тобольск на три дня
hasıl insanları havası		погода того как людей
Tuzlu hava durumu 		погода толстого васиковска
Terme  hava durumu		погода тольятти
Terme  için üç günlük hava durumu		погода тольятти на три дня
Terme  Ultav sokağı hava durumu		погода тольятти улица коммунальная
Ordu hava durumu		погода томск
Ordu haftalık hava durumu		погода томск на неделю
Tepeköy hava durumu		погода торопец
Tikenlice hava durumu		погода тосно
otuz Ağustos hava durumu		погода тридцатого августа
otuz Temmuz hava durumu		погода тридцатого июля
hava otuz		погода тридцать
otuz bir Ağustos hava durumu		погода тридцать первого августа
otuz bir Temmuz hava durumu		погода тридцать первого июля
on üç Ağustos hava durumu		погода тринадцатого августа
on üç Temmuz hava durumu		погода тринадцатое июля
yarın için Tire hava durumu		погода туймазы на завтра
Tire haftalık  hava durumu		погода туймазы на неделю
Tunceli hava durumu		погода тула
Tunceli Venev hava durumu		погода тула венев
Tunceli Venev hava durumu öğretirim		погода тула венев научу
Pazar Tunceli hava durumu		погода тула воскресенье
Tavas hava durumu		погода тулун
Tunceli ili Mazgirt hava durumu		погода тульская область венев
yarın için Tunceli bölgesi Yukarıbudak hava durumu		погода тульская область ефремов на завтра
Türkler hava durumu		погода турки
Nazımiye hava durumu		погода турочак горный алтай
hava sen resmen Şerlok Holmssın		погода ты вообще просто шерлок холмс
Trabzon hava durumu		погода тюмень
yarın için Trabzon hava durumu		погода тюмень на завтра
Trabzon üç günlük hava durumu		погода тюмень на три дня
Trabzon  otuz günlük hava durumu		погода тюмень на тридцать дней
Trabzon bugünkü hava durumu		погода тюмень сегодня
Diyarbakır karayolu hava durumu		погода у дина шоссе
Ekaterina'nın tuvaletindeki hava		погода у екатерины в туалете
Ovaeymir hava durumu		погода увильды
Uzunköprü hava durumu		погода удмуртия
Uğurludağ hava durumu		погода удомля
Üzbekistan hava durumu		погода узбекистан
Üzbekistan hava durumu		погода узбекистан бухара
Üzbekistan Buhara şehri hava durumu		погода узбекистан город бухара
Üzbekistan Karşi hava durumu		погода узбекистан карши
Üzbekistan Surhanderya Uzun hava durumu		погода узбекистан сурхандарья узун
Üzbekistan Taşkent hava durumu		погода узбекистан ташкент
Oğuzlar hava durumu		погода узген
Otlukbeli hava durumu		погода узловая
Ukraina Lugansk bölgesi Lisichansk hava durumu		погода украина луганская область лисичанск
Uşak hava durumu		погода улан удэ
Uşak on günlük hava durumu		погода улан удэ десять дней
yarın içinUşak  hava durumu		погода улан удэ на завтра
Oltu  hava durumu		погода ульяновск
yarın için Oltu  hava durumu		погода ульяновск на завтра
Oltu  üç günlük hava durumu		погода ульяновск на три дня
yarın için Oltu  hava durumu		погода ульяновске на завтра
Oltu  bugünkü  hava durumu		погода ульяновске на сегодня
Oltu  sabah hava durumu		погода ульяновске утром
Olur haftalık hava durumu		погода уразовка на неделю
yarın için Uren hava durumu		погода урень на завтра
Uzundere hava durumu		погода урус мартан
Odunpazarı haftalık hava durumu		погода урхучимахи на неделю
Kaman hava durumu		погода успенское
Ünye hava durumu		погода уссурийск
Ünye bugünkü hava durumu		погода уссурийск на сегодня
Oğuzeli hava durumu		погода устилимск
Yüksekova haftalık hava durumu		погода усть илим на неделю
Uluborlu hava durumu		погода усть каменогорск
Ümraniye hava durumu		погода усть кут
İstanbul  hava durumunu açıklayalım		погода уточним санкт петербурге
sabah hava		погода утро
sahah hava durumu		погода утром
Göksun'da sabah hava durumu		погода утром в гомеле
Uşak hava durumu		погода уфа
Ege bölgesi Uşak hava durumu		погода уфа башкортостан
Uşak akşam hava durumu		погода уфа вечером
Uşak aylık hava durumu		погода уфа на месяц
Uşak haftalık hava durumu		погода уфа на неделю
Uşak hafta hava durumu		погода уфа неделя
Uşak anlık hava durumu		погода уфа сейчас
Hanönü hava durumu		погода феодосия
Hanönü Bölükyazı hava durumu		погода феодосия береговое
Foreka Yahşihan hava durumu		погода форека великие луки
Karakeçili hava durumu		погода форт красная горка
Kulu  hava durumu		погода хабаровск
yarın için Kulu  hava durumu		погода хабаровск на завтра
Kulu  haftalık hava durumu		погода хабаровск на неделю
Kulu  hava durumu Toyota Gelios minibüsleri satışı		погода хабаровск продажа микроавтобус тойота гелиос
Kulu  ayrıntılı hava durumu		погода хабаровск с точностью до
Kulu  bugünkü hava durumu		погода хабаровский сегодня
Karapınar hava durumu		погода хабез сейчас
Ege bölgesi Fethiye hava durumu		погода хакасия нижнекамске
Ege bölgesi Serçin gölü hava durumu		погода хакасия озеро шира
Kadınhanı hava durumu		погода хамаматюрт
Karaağaç otuz bir Temmuz için hava durumu		погода ханты мансийск на тридцать первое июля
Karaağaç'ta hava durumu		погода ханты мансийске
Hekimhan hava durumu		погода хасавюрте
Kuluncak hava durumu		погода хасаут
Havza  hava durumu		погода химки
Havza  anlık hava durumu		погода химки сейчас
Kırkağaç hava durumu		погода ховрино
Hasköy ilçesi Yazla köyü hava durumu		погода хоринский район село иннокентьевка
Korkut hava durumu		погода хотилицы
Khudjand hava durumu		погода худжанд
Khudjand hava durumu ne maçoymuş		погода худжанд но и мачо
Khudjand hava durumu kaç şehir		погода худжанд сколько город
Toprakkale hava durumu		погода цаган аман
Aydın Nazilli hava durumu		погода цемдолина новороссийск
sirkta hava durumu		погода цирке
Tillo ilçesi Hatrant köyü hava durumu		погода цунтинском районе селение миатли
yirmi sekiz Ağustos Çanakçı hava durumu		погода цхинвал двадцать восьмое августа
Çamoluk hava durumu		погода чапаевск
hava durumu ne		погода че
Çanakkale  hava durumu		погода чебоксары
Amerika için Çanakkale hava durumu		погода чебоксары для америке
yarın için Çanakkale  hava durumu		погода чебоксары завтра
bugün Hacıbektaş hava durumu		погода челны сегодня
yarın için Çorlu hava durumu		погода челябинск завтра
Çorlu haftalık hava durumu		погода челябинск на неделю
Çorlu bugünlük hava durumu		погода челябинск на сегодня
Çorlu üç günlük hava durumu		погода челябинск на три дня
otuz kaç biri için Çorlu Tekirdağ hava durumu		погода челябинск чебаркуль на тридцать какой первый
Çorlu'da bugün hava durumu		погода челябинске на сегодня
Çubuk hava durumu		погода чембилей
Aydın Çine hava durumu		погода чепош горный алтай
Çeşmealtı  hava durumu		погода чердаклы
sekiz gün sonra hava durumu		погода через восемь дней
on yıl sonra hava durumu		погода через десять лет
bir ay sonra hava durumu		погода через месяц
bir ay sonra bu yerde hava durumu		погода через месяц место
bir hafta sonra hava durumu		погода через неделю
saat sonra hava durumu		погода через три часа üç
bir saat sonra hava durumu		погода через час
Çankırı hava durumu		погода череповец
yarın için Çankırı hava durumu		погода череповец завтра
Çankırı on günlük hava durumu		погода череповец на десять дней
Çankırı on beş günlük hava durumu		погода череповец на пятнадцать дней
Çan hava durumu		погода черкесск
dört Ağustos hava durumu		погода четвертого августа
Ankara 'da dört Ağustos hava durumu		погода четвертого августа в москве
dört Eylül hava durumu		погода четвертого сентября
dört günlük hava durumu lütfen		погода четыре дня можно
Denizli ili Çardak hava durumu		погода чехов сахалинская область
Çorum ili hava durumu		погода чеченская республика
hafta sonu için Şenpazar hava durumu		погода чирчик на выходные
Şebinkarahisar hava durumu		погода чистополь
yarın için Şebinkarahisar hava durumu		погода чистополь на завтра
yirmi bir Ağustos için Çıldır hava durumu		погода чита двадцать первое августа
Çatalköprü haftalık hava durumu		погода чугуевка на неделю
Çıkrıkçı  hava durumu		погода чулат
Çepnidere hava durumu		погода чурапча
Çepnibektaş hava durumu		погода чусовой
hafta sonu için Bayburt ili Demirözü hava durumu		погода чусовой пермский край на выходные
Şaartuz hava durumu şu an kaç		погода шаартуз а сейчас сколько
Tacikistan Şaartuz hava durumu		погода шаартуз таджикистан
Şırnak  hava durumu		погода шадринск
Şırnak  anlık hava durumu		погода шадринск сейчас
Hatay Antakya hava durumu		погода шамилькала дагестан
Çakırbağ hava durumu		погода шаркан
Çamlıköz hava durumu		погода шарья
Şaartuz hava durumu		погода шахритуз
Şabanözü hava durumu		погода шахты
Çerci üç günlük hava durumu		погода шебекино на три дня
Çiğdemtepe hava durumu		погода шелехов
yarın için Çatköy hava durumu		погода шеломенцево на завтра
Çavuş hava durumu		погода шемышейка
Bozüyük'te on altı Ağustos hava durumu		погода шестнадцатого августа в брянске
İstanbul 'da on altı Temmuz hava  durumu		погода шестнадцатого июля в санкт петербурге
altu Ağustos hava durumu		погода шестого августа
altu yıllık hava durumu		погода шесть год
Çatmakaya hava durumu		погода шибенец
yarın için Şereflikoçhisar hava durumu		погода шимановск на завтра
Akdeniz bölgesi  Seydişehir ilçesi Mesudiye köyü hava durumu		погода шимановский район село мухино амурская область
Sürmene hava durumu		погода шумерля
yarın için Çayeli hava durumu		погода щербинка на завтра
yarın Erzincan'da hava nasıl olacak?		погода электрогорск завтра как будет
Erzincan'da hava nasıl olacak?		погода электрогорск на как будет
Ereğli hava durumu		погода энгельс
yarın Ereğli'te hava durumu		погода энгельс завтра
Beşiktaş'ta yarın hava durumu		погода юдино на завтра на завтра
Sarıkamış hava durumu		погода южно сахалинск
Sarıkamış hava durumu		погода южный сахалин
Yalova haftalık hava durumu		погода якутск неделя
Yandex Hava Durumu Yozgat'da		погода яндекс в йошкар оле
Yandex Hava Durumu Suruç'ta		погода яндекс в селижарово
Yandex Hava Durumu haftalık		погода яндекс на неделю
Yandex Hava Durumu Narlıca		погода яндекс нальчик
Yandex Hava Durumu Siirt 		погода яндекс саратов
Japonya hava durumu		погода япония
yarın için Erciş hava durumu		погода ярково на завтра
Erciş ayrıntılı hava durumu		погода ярково подробно
Yenipazar hava durumu		погода яровое
Yenipazar haftalık hava durumu		погода яровое на неделю
Yozgat  hava durumu		погода ярославль
Pazar için Yozgat  hava durumu		погода ярославль на воскресенье
yarın için Yozgat  hava durumu		погода ярославль на завтра
Yozgat  saatlik kesin hava durumu		погода ярославль точный почасовой прогноз
hava açık		погода ясная
Bolvadin hava durumu		погода ясные зори
Ergani hava durumu 		погода яхрома
Cuma Pazar Ergani hava durumu		погода яхрома суббота воскресенье
Ceyhan şehri hava durumu		погод. г.хадыжск
Akhisar hava tahmini		погод. Хадвженск
Keller'de hava durumu		погод.в крымске
Turgutlu'da hava kötü		погодка отрицательный в тамбове
Kırım'da bugün hava felaketleri		погодные катаклизмы в крыму сегодня
Çanakkale Feribotu'nda hava durumu		погодные условия на керченской переправе
yarın Sarayköy'de hava durumu		погодным завтра в шерегеше
Kemer şehri hava durumunu		погоду в городе кемерово
Hopa şehri için haftalık hava durumunu göster		погоду в городе нижневартовск на неделю покажи
tam haftalık hava durumunu 		погоду на всю неделю
iki günlük hava durumu		погоду на два дня
Kuluncak günlük hava durumu		погоду на день королев
yarın için Sakarya hava durumunu		погоду на завтра в красноярске
yarın için Ordu hava durumunu		погоду на завтра в омске
yarın için Bayburt  hava durumunu		погоду на завтра в перми
yarın için Ereğli hava durumunu		погоду на завтра в энгельсе
yarın için Espiye hava durumunu		погоду на завтра флорешты
Trabzon aylık hava durumunu		погоду на месяц в тюмени
Çanakkale şehri için haftalık hava durumunu		погоду на неделю в городе радужном
Çıldır için haftalık hava durumunu		погоду на неделю в чите
Kağızman için haftalık hava durumunu		погоду на неделю касимов
haftalık hava durumunu tekrarla		погоду на неделю повтори
haftalık hava durumunu söyle		погоду на неделю скажи
Turgutreis için bugünkü hava durumu, lütfen		погоду на тиреллов пожалуйста на сегодня
NovoKarapürçek için üç günlük hava durumunu		погоду на три дня в новокузнецке
saatlik hava durumu		погоду по часам
Birgi için hava durumunu söyle		погоду скажи бажова
yarın Kangal için hava durumunu söyle salak		погоду скажи курица завтра в кустанае
hava durumunu söyle bana Ankara  için		погоду скажи мне в москве
hava durumunu söyle bana Akyaka mahallesi için		погоду скажи мне старой станице
hava durumunu söyle bana üç günlük Trabzon için		погоду скажи на три дня в тюмени
havaalanı meteorologları hava tahminleri		погоды метеорологов аэропорта
yarın için Şahmaran hava durumu		погоды на завтра в старом тимошкино
hava tahmini aylık İnguşetya için		погоды прогноз погоды на месяц в ингушетии
Ortaklı hava durumu		погоды уваров
Kemerov bölgesi Kiselyevsk hava durumu		погожа в киселёвске кемеровской области
Gümüşhane  haftalık hava durumu		погона неделю находка
yarın için Bafra hava durumu		погоны погода в барнауле на завтра
İslahiye Kırıkçalı  on günlük hava durumu		подмосковье старая купавна погода на десять дней
Posyağbasan hava durumu		подольске погода
Serik için ayrıntılı hava durumu		подробная погода в сызрани
Karadeniz bölgesi Çilimli için bugün saatlik ayrıntılı hava durumu		подробная погода в черниговке приморского края на сегодняшний день по часам
Bitlis için ayrıntılı hava durumu		подробная погода на бутурлиновка
yirmi dördü Nevşehir  için ayrıntılı hava durumu		подробная погода на двадцать четвертое число новосибирск
haftalık ayrıntılı hava durumu		подробная погода на неделю
Pamukova şehri için saatlik ayrıntılı hava durumu		подробная погода по часам в городе пенза
 Tavşanlı için bugünkü ayrıntılı hava durumu		подробная погода сегодня в воронеже
Pamukova için ayrıntılı sıcaklık 		подробная температура в пензе
Silvan hava durumu hakkında daha detaylı		подробнее о погоде в смоленске
Tunceli hava durumu hakkında daha detaylı		подробнее про погоду в туле
Ankara  hava durumu hakkında daha detaylı		подробно в москве погода
Balâ için iki günlük ayrıntılı hava tahmini		подробный прогноз погоды в большом баландино на два дня
Polatlı şehri için ayrıntılı hava tahmini		подробный прогноз погоды в городе пыть ях
Korgan için ayrıntılı hava tahmini		подробный прогноз погоды в калмыкии
Ankara  için ayrıntılı hava tahmini		подробный прогноз погоды в москве
yarın Bilecik  için ayrıntılı hava tahmini		подробный прогноз погоды на завтра в петрозаводске
Bergama şehri için haftalık ayrıntılı hava tahmini		подробный прогноз погоды на неделю город вологда
Çolaklar kasabası için ayrıntılı hava tahmini		подробный прогноз погоды поселок чулково
Gazientep İslahiye ilçesi Çolaklar kasabası için ayrıntılı hava tahmini		подробный прогноз погоды поселок чулково выборгский район ленинградская область
arkadaş Çankaya için bugünkü hava durumu		подруга погода в егорьевске сегодня
akşam dokuzda Kadirli'de hava nasıl olacak söylesene 		подскажи какая погода будет девять часов вечера котельниках
Kütahya'da hava durumunu nasıl söylesene 		подскажи какая погода в калуге
yarın Serik'te hava durumu nasıl olacak söylesene 		подскажи какая погода завтра в сызрани
Silvan'da hava durumu nasıl söylesene		подскажи какой прогноз погоды в староминской
on üçü on dördü için Düziçi hava tahminini söylesene		подскажи мне погоду в спасск дальний тринадцатое четырнадцатое августа
Ağustos başı Balıklıova kasabası için hava durumunu söylesene		подскажи мне погоду на начало августа в станице благовещенская
Çörten için hava durumunu söylesene		подскажи мне погоду на чемале
o büyük Alisa bize yarın için Ankara  hava durumunu söylesene		подскажи нам погоду великая алиса на завтра в москве
Göksun hava durumunu söylesene		подскажи погода в гомеле
yarın için Cilo dağı hava durumunu söylesene		подскажи погоду на завтра на горе эльбрус
beş günlük hava durumunu söylesene		подскажи погоду на пять дней
Çatak hava durumunu nerede bulabileceğimi söylesene lütfen		подскажи пожалуйста где находится погода в чертково
yarın Malatya'da hava nasıl olacağını söylesene lütfen		подскажи пожалуйста завтра какая погода в махачкале
şimdi on günlük hava durumunu  söylesene lütfen		подскажи пожалуйста какая сейчас погода на десять дней
haftalık hava durumunu  söylesene 		подскажи там погоду на неделю
bu günler için hava durumunu söylesene lütfen		подскажите мне пожалуйста погоду на эти дни
İstanbul'daki hava durumunu söyleyin		подскажите погоду в санкт петербурге
lütfen Karaman ili Sarıveliler şehrinde bugün hava nasıl olması bekleniyor		пожалуйста какая погода сегодня ожидается в городе гусеве калининградской области
Temmuz  Asarcık Samsun ili hava durumu lütfen		пожалуйста погоду в алапаевске на третье июля свердловская область üç
on sekiz on dokuz Ağustos için Van'da hava durumu lütfen 		пожалуйста погоду на восемнадцатое девятнадцатое августа во владимире
Çanakçı için bugünkü hava durumu lütfen		пожалуйста погоду на сегодня в новочеркасске
Samsun ili Salıpazarı şehri için hava durumunu söyleyin lütfen		пожалуйста подскажите погоду в городе ставрополь ставропольского края
yarın için Van Van hava durumu lütfen		пожалуйста прогноз на завтра великий новгород великий новгород
lütfen yarın için Oltu hava durumunu söyle		пожалуйста скажи погоду на завтра в одинцово
Aydın ili Didim için hava durumunu lütfen söyleyin bana 		пожалуйста скажите мне погода леньки алтайский край
Terme hava durumu lütfen		пожалуйста термез погода
dün hava nasıldı lütf lütfen		поза поза вчера какая погода
Aralık için hava durumunu internette ara 		поищи в интернете погода в декабре
Mahmutlar yarın için hava durumunu ara ve burada seslendir		поищи погоду на завтра в миассе  и озвучь ее здесь
Kuşoturağı yedi hava durumunu göster		пока станица кумылженская семь погода
Geyve  için hava durumunu göster		покажи в грозном погода
bana ne zaman Ankara'da sıcak günler olacağını göster		покажи мне когда будут теплые дни в москве
yarın için Damarlıtaş hava durumunu göster bana		покажи мне на завтра погоду в мирном
Ağustos için aylık hava durumu göster bana		покажи мне на целый месяц погода августа
Ekim Eylül ayları için Aydın ili hava durumu tahminini göster bana		покажи мне ориентировочную погоду республика алтай на месяц октябрь сентябрь
bugün akşam için Bahçebaşı için hava durumunu göster bana		покажи мне погоду в большегривском на сегодня вечером будет
Dörtyol  hava durumunu göster bana 		покажи мне погоду в дербенте
Kaynaşlı hava durumunu göster bana 		покажи мне погоду в кореновске
Ankara  için haftalık hava durumunu göster bana 		покажи мне погоду в москве на неделю
Niğde için hava durumunu göster bana 		покажи мне погоду в новошахтинске
yarın için Haymana hava durumunu göster bana		покажи мне погоду в хайфе на завтра
Pursaklar için hava durumunu göster bana		покажи мне погоду на восточном
Yenipazar için detaylı hava durumunu göster bana		покажи мне полный прогноз погоды в яровом
Düzce şehri kasabası için detaylı hava durumunu göster bana		покажи мне полный прогноз погоды поселок городе демидове
Van ili için önümüzdeki haftaya hava durumunu göster bana		покажи мне прогноз в во владимирской области на ближайшую неделю
yirmi dokuz Temmuz için hava durumunu göster bana		покажи на двадцать девятое июля погода
on beş Temmuz Kabadüz Ordu için hava durumunu göster 		покажи погода красноармейск саратовская на пятнадцатое августа
haftalık hava durumunu göster 		покажи погода на неделю
Arzupınar hava durumunu göster 		покажи погоду в атманов угол
Vakfıkebir için bugünkü hava durumunu göster 		покажи погоду в воткинске на сегодня
Gökdere için hava durumunu göster 		покажи погоду в геническе
yarın için Donetsk hava durumunu göster 		покажи погоду в донецке на завтра
Eriklitekke için hava durumunu göster 		покажи погоду в ермекеево
Kahramanmaraş için hava durumunu göster 		покажи погоду в казани
Manisa  için hava durumunu göster 		покажи погоду в курске
Ankara  için hava durumunu göster 		покажи погоду в москве
önümüzdeki haftaya Çandarlı hava durumunu göster 		покажи погоду в натурель гурт на ближайшую неделю
Hanımın Çiftliği için haftalık hava durumunu göster 		покажи погоду в нефтеюганске на неделю
Oltu için hava durumunu göster 		покажи погоду в одинцово
Karaman için on günlük hava durumunu göster 		покажи погоду в рязани на десять дней
Silopi için hava durumunu göster 		покажи погоду в самаре
Çankırı için saatlik hava durumunu göster 		покажи погоду в течении часа в городе череповце
Turhal için hava durumunu göster 		покажи погоду в туапсе
önümüzdeki üç gün için hava durumunu göster 		покажи погоду на ближайшие три дня
Pazar için hava durumunu göster 		покажи погоду на воскресенье
Bafra yarın için hava durumunu göster 		покажи погоду на завтра барнаул
Sakarya yarın için hava durumunu göster 		покажи погоду на завтра в красноярске
bugün yarın için Tunceli hava durumunu göster 		покажи погоду на завтра в тобольске сегодня
yarın için Çorlu hava durumunu göster 		покажи погоду на завтра в челябинске
yarın için Ereğli hava durumunu göster 		покажи погоду на завтра в энгельсе
aylık hava durumunu göster 		покажи погоду на месяц
haftalık hava durumunu göster 		покажи погоду на неделю
Ankara  için haftalık hava durumunu göster 		покажи погоду на неделю в москве
Saray için haftalık hava durumunu göster 		покажи погоду на неделю в сарапуле
İstanbul için haftalık hava durumunu göster 		покажи погоду на неделю петербурге
üç günlük hava durumunu göster 		покажи погоду на три дня
saatlik hava durumunu göster 		покажи погоду по часам
bugün için saatlik hava durumunu göster 		покажи погоду по часам на сегодня
orta hava durumunu göster 		покажи погоду половины
otuz altı hava durumunu göster 		покажи погоду тридцать шесть
Borçka için iki günlük hava durumunu göster lütfen		покажи пожалуйста погоду в бирске на два дня
Kahta için hava durumunu göster lütfen		покажи пожалуйста погоду в коркино
Sinop Mucur kasabası hava durumunu göster lütfen		покажи пожалуйста сочи поселок лазаревское погоду
Çankaya'da hava durumu tablosunu göster		покажи таблицу погоды в егорьевске
Kuta için haftalık sıcaklık oranını göster		покажи температуру куте на неделю
Çardak ilçesi hava durumunu göster		покажи чеховский район погода
Başçiftlik hava durumunu göster		покажите владивосток погода
Sulusaray'da yarın hava nasıl olacağını gösterin 		покажите какая завтра будет погода в бала четырман
Bingöl hava durumunu gösterin bana		покажите мне погода балашиха
yarın için Kemer'de saatlik sıcaklık oranını gösterin 		покажите по часам температура в кемере на завтра
Ordu için hava durumunu gösterin 		покажите погоду в омске
İzmir için haftalık hava durumunu gösterin 		покажите погоду на неделю в иркутске
Geyve  için bugünkü hava durumunu gösterin 		покажите погоду на сегодня в грозном
yirmisinden otuz bir Temmuza kadar Ayancık için seyahat hava durumunu gösterin 		покажите поход погода в адлере с двадцатого по тридцать первое июля
Salıpazarı ili  İlkadım şehri için net hava durumunu gösterin 		покажите точную погоду город изобильный ставропольский край
Ödemiş şehri için hava durumunu göstermek		показать в орле город погоду
ben Uşak'tayım Uşak için hava durumunu göstermek		показать погода в уфе потому что я нахожусь в уфе
Abhazya için hava durumunu göstermek		показать погоду в абхазии
Göle hava durumunu göstermek		показать погоду в голубицкой
Denizli ili Merkezefendi ilçesi hava durumunu göstermek		показать погоду в красненском районе липецкой области
Mamak hava durumunu göstermek		показать погоду в малаховке
Ankara ili Mamak hava durumunu göstermek		показать погоду в малаховке московская область
Ordu için on günlük hava durumunu göstermek		показать погоду в омске на десять дней
Hatay ili Samandağ için hava durumunu göstermek		показать погоду в солнечном хабаровского края
yirmi iki Eylül için Kırşehir hava durumunu göstermek		показать погоду на двадцать второе сентября город краснодар
haftalık hava durumunu göstermek		показать погоду на неделю
Havza  için haftalık hava durumunu göstermek		показать погоду на неделю в городе химки
Adapazarı ilçesi Kömürlük köyü Sakarya ili için haftalık hava durumunu göstermek		показать погоду на неделю назаровский район красная поляна красноярский край
Gönen için bugünkü hava durumunu göstermek		показать погоду на сегодня в глотку
Donetsk için bugünkü hava durumunu göstermek		показать погоду на сегодня в донецке
yirmi iki Eylül Kemer Limanı Kemer şehri için hava durumunu göstermek		показать погоду порт кавказ на двадцать второе сентября город керчь
yirmi bir Eylül Kemer Limanı için hava durumunu göstermek		показать погоду порт кавказ на двадцать первое сентября
haftalık hava durumunu göstermek		показать прогноз погоды на неделю
sabah artı sekiz akşam on sekiz demek		получается утром плюс восемь а вечером восемнадцать
hava durumu için şehri değiştirmek		поменять город погоды
Ordu ili Yalıköy için hava durumu yardım edin		помог погода в одесском омской области
pazartesi için hava durumu ne		понедельник какая погода
pazartesi hava durumu		понедельник погода
pazartesi hava durumu		понедельника погода
Kırım'da yaşadığımın farkındayım ama Kırım'da hava nasıl		понимаю что я живу в крыму а в крыму какая погода
anladın mı beni Tokat hava durumu		поняла меня курган погода
tamam bugün akşam için hava durumunu söyleyiver		понятненько скажи ка мне погода сегодня вечером
tamam yarın Vezirköprü'de hava nasıl olacak		понятно какая погода завтра будет в волгограде
tamam şu an Prag'da hava durumu nasıl		понятно какая погода сейчас в праге
tamam Karaburun'da bugün hava nasıl		понятно погода в кювете сегодня
mini toy terrier türü		порода мини той терьера
Bağlun kasabası Ankara  ili hava durumu		поселке раздоры московская область погода
Dikili kasabası hava durumu		поселок Инзер погода
Çukurbağ kasabası Antalya bugünkü hava durumu		поселок витязево анапа прогноз погоды на сегодня
Özdere kasabası İzmir ili yarın için hava durumu		поселок залари иркутской области погода на завтра
Çamlıhemşin kasabası Karadeniz bölgesi  hava durumu		поселок ливадия приморский край погода
Damarlıtaş kasabası Oltu ilçesi Erzurum ili yarın için hava durumu		поселок мирный ульяновская область чердаклинский район погода на завтра
Çeşmealtı kasabası bugünkü hava durumu		поселок морское погода сегодня
Çeşmealtı kasabası kaç derece bugün		поселок морское сколько градусов сегодня
Mordoğan kasabası hava durumu		поселок новосергеевка погоды
Ağva kasabası hava durumu		поселок ольга погода
Birgi kasabası kaç hava durumu 		поселок повадино сколько погода
Süphandere kasabası hava durumu		поселок седово погода
Süphandere kasabası haftalık hava durumu		поселок седово погода на неделю
Cunda kasabası bugünkü hava durumu		поселок утулик погода на сегодня
Amasra kasabası hava durumu		поселок энергетик погода
diabetten sonra hava durumuna baksana lütfen		после диабет посмотри пожалуйста погода
öğleden sonra Sevindi'de hava durumu		после обеда погода в старом осколе
yarından sonra ve daha sonra hava nasıl olacak		после послезавтра какая будет погода
yarından sonra Bozüyük hava durumu		послезавтра брянск погода
yarından sonra Malatya'da hava nasıl olacak		послезавтра какая будет погода в махачкале
yarından sonra hava nasıl Araç 		послезавтра какая погода ачинск
yarından sonra Milas’ta hava nasıl 		послезавтра какая погода в можайске
yarından sonra Ankara ’da hava nasıl 		послезавтра какая погода в москве
yarından sonra Hanönü ’nde hava nasıl 		послезавтра какая погода в феодосии
yarından sonra Şabanözü'nde hava nasıl olacak		послезавтра когда какая будет погода в шахтах
yarından sonra Piraziz'de hava nasıl 		послезавтра погода в пскове
yarından sonra Seydiler'de hava nasıl 		послезавтра погода в советской
yarından sonra Bayburt ilçesi Çamlıköz'de hava nasıl 		послезавтра погода в чусовом пермский край
yarından sonra sabah artı yirmi yirmi üçten artı sekize kadar yerli  		послезавтра утром в от двадцать плюс двадцать три до плюс восьми местные
Zile için hava durumunu izlemek 		посмотреть погоду в зеленце
Yalıkavak için haftalık hava durumunu izlemek		посмотреть погоду в ялте на неделю
dördü ve beşi için Sinop hava durumunu izlemek 		посмотреть погоду в ялте на третье четвертое и пятое число üçü
Sakarya hava durumuna bak		посмотри погоду в красноярске
yirmi iki Temmuz için Aydın hava durumuna bak 		посмотри погоду на алтае двадцать второго июля
yirmisinden hava durumuna bak		посмотри погоду с двадцать
Yulia on altısı on yedisi on sekizi on dokuzu için hava durumuna bakabilir misiniz, lütfen		посмотрите пожалуйста какая будет погода шестнадцатый семнадцатый восемнадцать девятнадцать двадцатой юля
Kahramanmaraş'ta hava ısınacak mı		потеплеет ли в казани
çünkü bilmiyorsun Duraan hava durumu		потому что не знаешь погода в пижанке
ben sana hava durumunu bul ve göster dedim sen de bana söyledin		потому что я попасть и показать погоду а ты мне сказала
saatlik hava durumu		почасовая погода
Antakya için saatlik hava durumu		почасовая погода в арсеньеве
Başçiftlik şehri içib saatlik hava durumu		почасовая погода в городе владивосток
Kalecik için saatlik hava durumu		почасовая погода в красногорске
saatlik hava durumu Lidoga için		почасовая погода в лидоге
saatlik hava durumu Ladik için		почасовая погода в людиново
saatlik hava durumu Ankara  için		почасовая погода в москве
saatlik hava durumu yarın için		почасовая погода на завтра
saatlik hava durumu bugün için		почасовая погода на сегодня
saatlik hava durumu Ovaeymir için		почасовая погода на увильдах
saatlik hava durumu		почасовой прогноз
saatlik hava tahmini  Anamur'da		почасовой прогноз в апшеронске
saatlik hava tahmini Malatya'da bugün için		почасовой прогноз в махачкале на сегодня
saatlik hava tahmini bugün için		почасовой прогноз на сегодня
saatlik Aydıncık'ta hava durumu tahmini bugün için		почасовой прогноз погоды в арзамасе на сегодня
saatlik hava durumu tahmini Dicle için		почасовой прогноз погоды в димитровграде
saatlik hava durumu tahmini Karaman'da yarın için		почасовой прогноз погоды в калининграде на завтра
saatlik hava durumu tahmini Londra'da fabrikada		почасовой прогноз погоды в лондоне заводе
saatlik hava durumu tahmini Nizip'te bugün		почасовой прогноз погоды в новодвинске сегодня
saatlik hava durumu tahmini Ödemiş'te		почасовой прогноз погоды в орле
saatlik hava durumu tahmini Narlı kasabaı haftalık		почасовой прогноз погоды в станице надежной на неделю
saatlik hava durumu tahminiyarın için		почасовой прогноз погоды на завтра
saatlik hava durumu tahmini Buzova raın için		почасовой прогноз погоды на завтра бузову
saatlik hava durumu tahmini Narlı için bugün için		почасовой прогноз погоды на надежный на сегодня
saatlik hava durumu tahmini Terme  bugün için		почасовой прогноз тольятти на сегодня
saatlik hava durumu tahmini Bakırca Çorlu ilşesi üç güne		почасовой прогнозы погоды варево челябинская область  на 3 дня
saatlik hava durumu İzmir için bugün		почасовую погоду на иркутск сегодня
