haberleri aç	"haberleri"(target_type) aç	open news
haberlerde ne var	"haberlerde"(target_type) ne var	what's on news
bugünün haberleri	"bugünün"(when) "haberleri"(target_type)	today's news
bugün haberlerde ne var	"bugün"(when) "haberlerde"(target_type) ne var	what's on today's news
dolar bilgisi göster	"dolar"(target_type) bilgisi göster	show dollar informatin
bugün dolar ne kadar göstersene	"bugün"(when) "dolar"(target_type) ne kadar göstersene	show how much is dollar today
bugün gündem nedir	"bugün"(when) "gündem"(target_type) nedir	what is the agenda today
hürriyeti aç	"hürriyeti"(target_type) aç	open hürriyet
hürriyet haberleri aç	"hürriyet haberleri"(target_type) aç	open hürrriyet news
hürriyet anasayfasını aç	"hürriyet anasayfasını"(target_type) aç	open hürriyet mainpage
facebooku aç	"facebooku"(target_type) aç	open facebook
facebooka gir	"facebooka"(target_type) gir	go to facebook
instagramı aç	"instagramı"(target_type) aç	open instagram
instagrama gir	"instagrama"(target_type) gir	go to instagram
facebook mesajlara gir	"facebook mesajlara"(target_type) gir	go to facebook messages
facebook messengerı aç	"facebook messengerı"(target_type) aç	open facebook messenger
spor haberlerini aç	"spor haberlerini"(target) aç	open sport news
maç sonuçlarını aç	"maç sonuçlarını"(target) aç	open match results
youtube aç	"youtube"(target_type) aç	open youtube
youtube izle	"youtube"(target_type) izle	watch youtube
youtube video	"youtube video"(target_type)	youtube video
komik video aç	"komik video"(target) aç	open funny video
navigasyonu aç	"navigasyonu"(target_type) aç	open navigation
yandex navigasyona gir	yandex "navigasyona"(target_type) gir	go to navigation yandex
kamerayı aç	"kamerayı"(target) aç	open camera
fotoğraf çekicem kamera aç	fotoğraf çekicem "kamera"(target) aç	I'll take photos open camera
hesap makinesini aç	"hesap makinesini"(target) aç	open calculator
takvime gir	"takvime"(target) gir	go to calendar
takvime gir bugün	"takvime"(target) gir "bugün"(when)	go to calendar today
takvimi aç	"takvimi"(target)aç	open calendar
maillerime bakmak istiyorum	"maillerime"(target) bakmak istiyorum	I want to look my mails
maillerimi açar mısın	"maillerimi"(target) açar mısın	can you open my mails
bugün gelen mailler	"bugün"(when) gelen "mailler"(target)	today incoming mails
e postamı aç	"e postamı"(target) aç	open my emails
e posta uygulamasına girer misin	"e posta uygulamasına"(target_type) girer misin	can you go to email app
müzik aç	"müzik"(target) aç	open music
spotifya gir	"spotifya"(target_type) gir	go to spotify
spotify aç	"spotify"(target_type) aç	open spotify
whatsapp açar mısın	"whatsapp"(target_type) açar mısın	can you open facebook
whatsappta mesaj yazıcam	"whatsappta"(target_type) mesaj yazıcam	I'll write message on whatsapp
whatsapp uygulamasını açmayı biliyor musun	"whatsapp uygulamasını"(target_type) açmayı biliyor musun	do know to open whatsapp application
getir aç	"getir"(target_type) aç	open getir
getirden sipariş vericem	"getirden"(target_type) sipariş vericem	I'll place an order at getir
getir uygulamasına gir	"getir uygulamasına"(target_type) gir	go to getir application
twitter	"twitter"(target_type)	twitter
twitterı açsana	"twitterı"(target_type) açsana	open twitter
ekşisözlük sitesini aç	"ekşisözlük sitesini"(target_type) aç	open sourtimes site
ekşisözlüğü aç	"ekşisözlüğü"(target_type) aç	open sourtimes
ekşisözlüğe gir	"ekşisözlüğe"(target_type) gir	go to sourtimes
snapchat açar mısın	"snapchat"(target_type) açar mısın	can you open snapchat
tiktok uygulamasını aç	"tiktok uygulamasını"(target_type) aç	open tiktok app
tiktoka girsene	"tiktoka"(target_type) girsene	go to tiktok
fb messengera gir	"fb messengera"(target_type) gir	go to facebook messenger
ayarlarıma gir	"ayarlarıma"(target) gir	go to my settings
fotoğrafları aç	"fotoğrafları"(target) aç	open photos
foto albümünü aç	"foto albümünü"(target) aç	open photo album
fotoğraflara bakmak istiyorum	"fotoğraflara"(target) bakmak istiyorum	I want to look at photos
fotoğraflarım nerede	"fotoğraflarım"(target)nerede	where are my photos
pubg oynamak istiyorum	"pubg"(target_type) oynamak istiyorum	I want to play pubg
pubg oyunu 	"pubg oyunu"(target_type)	pubg game
candy crush oynayalım aç	"candy crush"(target_type) oynayalım aç	let's play candy crush open
candy crushı aç	"candy crushı"(target_type) aç	open candy crush
netflixte film izleyeceğim	"netflixte"(target_type) film izleyeceğim	I'll watch movie on netflix
netflixten film aç	"netflixten"(target_type) film aç	open a movie at netflix
netflixte dizimi açsana	"netflixte"(target_type) dizimi açsana	open my series at netflix
edevlete gir	"edevlete"(target_type) gir	go to edevlet
edevletin sitesine gir	"edevletin sitesine"(target_type) gir	go to edevlet website
edevlet uygulamasına gir	"edevlet uygulamasına"(target_type) gir	go to edevlet app
letgoya girmek istiyorum	"letgoya"(target_type) girmek istiyorum	I want to go to letgo
letgoda eşya arayalım	"letgoda"(target_type) eşya arayalım	let's search at letgo
uygulamalarımı açar mısın yandex	"uygulamalarımı"(target) açar mısın yandex	can you open my applications yandex
mesajlarıma girer misin	"mesajlarıma"(target) girer misin	can you go to my messages
yeni mesajım var mı	yeni "mesajım"(target) var mı	do I have a new message
sms yollamak istiyorum	"sms"(target) yollamak istiyorum	I want to send SMS
whatsapp yollamam gerek	"whatsapp"(target_type) yollamam gerek	I have to send whatsapp
youtube komik video aç	"youtube" (target_type)komik video aç	open youtube funny video
kişilerime gir	"kişilerime"(target) gir	go to my contacts
kontaklara gir	"kontaklara"(target) gir	go to contacts
arama yapalım	"arama"(target) yapalım	let's make a call
annemi aramak istiyorum	annemi aramak istiyorum	I want to call my mother
babamı arasana	babamı arasana	call my father
kişilerime gir	"kişilerime"(target) gir	go to my contacts
kişilerime gir babam	"kişilerime"(target) gir babam	go to my contacts my father
müziklerime gir	"müziklerime"(target) gir	go to my music
alarma gir	"alarma"(target) gir	go to alarm
saati kurucam	"saati"(target) kurucam	I'll set time
saati aç alarm kuralım	"saati aç"(target) "alarm"(target) kuralım	open time let's set the alarm
hava durumunu açar mısın	"hava durumunu"(target) açar mısın	can you open weather
interneti aç	"interneti"(target) aç	open internet
bluetoothu aç	"bluetoothu"(target) aç	open bluetooth
wi fi aç	"wi fi"(target) aç	open wi fi
feneri aç	"feneri"(target) aç	open flashlight
ışığı aç	"ışığı"(target) aç	open light
mobil veriyi aç	"mobil veriyi"(target) aç	open mobile data
uçak modunu aç	"uçak modunu"(target) aç	open airplane mood
hotspot açsana	"hotspot"(target) açsana	open hotspot
airdrop açık mı	"airdrop"(target) açık mı	is airdrop open
airdropa gir	"airdropa"(target) gir	go to airdrop
albümlere gir	"albümlere"(target) gir	go to albums
garanti.com.trye git	"garanti.com.trye"(target_type) git	go to garanti.com.tr
onedioyu aç	"onedioyu"(target_type) aç	open onedio
onedio.com a girsene	"onedio.com"(target_type) a girsene	go to onedio.com
sabah gazetesini aç	"sabah gazetesini"(target_type) aç	open sabah newspaper
sabahı aç	"sabahı"(target_type) aç	open sabah
google açsana	"google"(target_type) açsana	open google
google'da arama yapmak istiyorum	"google'da"(target_type) arama yapmak istiyorum	I want to make a search on google
yandex arama motorunu aç	"yandex arama motorunu"(target_type) aç	open yandex search engine
yandex'e gir	"yandex'e"(target_type) gir	go to yandex
youtube websitesi	"youtube websitesi"(target_type)	youtube website
youtube uygulamasına gir	"youtube uygulamasına"(target_type) gir	go to youtube app
youtubeda müzik aç	"youtubeda"(target_type) "müzik"(target_type) aç	open music on youtube
sahibindene gir	"sahibindene"(target_type) gir	go to sahibinden
sahibinden sitesine git	"sahibinden sitesine"(target_type) git	go to sahibinden site
sahibinden uygulamasını aç	"sahibinden uygulamasını"(target_type) aç	open sahibinden app
haber7'yi açsana	"haber7'yi"(target_type) açsana	open haber7
haber7 haberler	"haber7"(target_type) haberler	haber7 news
ensonhabere git	"ensonhabere"(target_type) git	go to ensonhaber
google mapsleri aç	"google mapsleri"(target_type) aç	open google maps
google mapsi aç	"google mapsi"(target_type) aç	open google maps
google haritaları aç	"google haritaları"(target_type) aç	open google maps
yandex haritalara girsene	"yandex haritalara"(target_type) girsene	go to yandex maps
notları aç	"notları"(target) aç	open notes
notlara gir	"notlara"(target) gir	go to notes
app store u aç	"app store u"(target_type) aç	open app store
app store uygulamasına gir	"app store uygulamasına"(target_type)  gir	open app store app
itunes a gir	"itunes a"(target_type)  gir	go to itunes
itunesu aç	"itunesu"(target_type)  aç	open itunes
kişisel erişimi aç	"kişisel erişimi"(target) aç	open personal hotspot
kişisel erişim noktası	"kişisel erişim noktası"(target)	personal hotspot
bildirimlerime git	"bildirimlerime"(target) git	go to notifications
denetim merkezine git	"denetim merkezine"(target) git	go to system preferences
siriyi aç	"siriyi"(target_type) aç	open siri
videolara git	"videolara"(target) git	go to videos
fotoğraflara git	"fotoğraflara"(target) git	go to photos
