text	intent	weight
камера дпс	personal_assistant.navi.add_point	1
елизаветинское шоссе 29	personal_assistant.scenarios.find_poi	1
отменить маршрут отменить	personal_assistant.navi.reset_route	1
удалить все набережная маршруты	personal_assistant.scenarios.other	1
переяславский 4 поехали	personal_assistant.scenarios.show_route	1
ну да да да	personal_assistant.scenarios.other	1
пробки на большевички	personal_assistant.scenarios.show_traffic	1
построить маршрут электродепо новогиреево	personal_assistant.scenarios.show_route	1
поехали лесная	personal_assistant.scenarios.show_route	1
укажите мое местоположение	personal_assistant.scenarios.get_my_location	1
по какому адресу я нахожусь	personal_assistant.scenarios.get_my_location	1
найди меня улица	personal_assistant.scenarios.get_my_location	1
скорбит	personal_assistant.scenarios.other	1
поворот елино елино	personal_assistant.scenarios.other	1
показать автомобильные пробки	personal_assistant.navi.show_layer	1
следить за машина	personal_assistant.scenarios.other	1
22 показать весь маршрут	personal_assistant.navi.show_route_on_map	1
занимались	personal_assistant.scenarios.other	1
новоалексеевская 18 корпус 1 поехали	personal_assistant.scenarios.show_route	1
лалели лор	personal_assistant.scenarios.other	1
проложить дорогу ближайший сбербанк россии в солнечногорске	personal_assistant.scenarios.show_route	1
говорите направо налево	personal_assistant.scenarios.other	1
сбрось маршрут	personal_assistant.navi.reset_route	1
есть такой предприниматель ветров	personal_assistant.scenarios.other	1
проложить маршрут от города куровское до города коломна улица зеленая дом 30	personal_assistant.scenarios.show_route	1
все для	personal_assistant.scenarios.other	1
проспект героев поехали	personal_assistant.scenarios.show_route	1
автосуши	personal_assistant.scenarios.find_poi	1
точный адрес моего местоположения	personal_assistant.scenarios.get_my_location	1
погоду летать на восток порт за бортом	personal_assistant.scenarios.other	1
охта молл поехали	personal_assistant.scenarios.show_route	1
как быстро доехать сормовская 214	personal_assistant.scenarios.show_route	1
я думала может быть	personal_assistant.scenarios.other	1
майкоп краснодар целиноградная 26 показать пробки	personal_assistant.scenarios.find_poi	1
здравствуйте здравствуйте	personal_assistant.scenarios.other	1
грина 1 корпус 8 поехали	personal_assistant.scenarios.show_route	1
мезмай	personal_assistant.scenarios.find_poi	1
колумнея	personal_assistant.scenarios.find_poi	1
показать адрес дом есть сейчас нахожусь	personal_assistant.scenarios.get_my_location	1
окмачит	personal_assistant.scenarios.find_poi	1
бейсекова 22 / 1 где находится	personal_assistant.scenarios.find_poi	1
маршрут закончен сбросить	personal_assistant.navi.reset_route	1
запрещено стоит	personal_assistant.navi.add_point	1
лежена 6 / 2	personal_assistant.scenarios.find_poi	1
все правильно	personal_assistant.scenarios.other	1
где я приехал	personal_assistant.scenarios.other	1
здесь и сейчас	personal_assistant.scenarios.other	1
что молчишь не говоришь куда ехать	personal_assistant.scenarios.other	1
проезд без пробок	personal_assistant.scenarios.show_route	1
поспать	personal_assistant.scenarios.other	1
парковка у парковка у метро	personal_assistant.scenarios.find_poi	1
и тупит	personal_assistant.scenarios.other	1
построить разговорчики	personal_assistant.navi.add_point	1
бишкеке пробки покажи	personal_assistant.scenarios.show_traffic	1
убери пробки	personal_assistant.navi.hide_layer	1
говорите яндекс пробки	personal_assistant.scenarios.show_traffic	1
построй маршрут кирова	personal_assistant.scenarios.show_route	1
юникло	personal_assistant.scenarios.find_poi	1
машина стоит	personal_assistant.navi.add_point	1
интернете 40 р вот он село чугинка абрау оплатить парковку в заплатил на 20 минут что там 40 р в час 40x3 разделить на московском 15	personal_assistant.scenarios.other	1
измайловское шоссе 71 корпус 2 поехали	personal_assistant.scenarios.show_route	1
пролетарская поехали	personal_assistant.scenarios.show_route	1
написать сообщение	personal_assistant.navi.add_point	1
сиражудинова 97 построить маршрут	personal_assistant.scenarios.show_route	1
пробки на дороге	personal_assistant.scenarios.show_traffic	1
я скажу	personal_assistant.scenarios.other	1
я нахожусь где	personal_assistant.scenarios.get_my_location	1
луначарского 83 поехали	personal_assistant.scenarios.show_route	1
на челны через пермь	personal_assistant.scenarios.show_route	1
паб строительство посмотрим где пробка был не будет 7	personal_assistant.scenarios.other	1
через кронштадт	personal_assistant.scenarios.show_route	1
неправильно показывает дорогу	personal_assistant.scenarios.other	1
почему молчит	personal_assistant.scenarios.other	1
вижу а	personal_assistant.scenarios.other	1
пробки пробки	personal_assistant.scenarios.show_traffic	1
как проехать город смоленск	personal_assistant.navi.show_layer	1
юкки где находится	personal_assistant.scenarios.find_poi	1
пробки на скандинавском шоссе показать	personal_assistant.scenarios.show_traffic	1
отачь	personal_assistant.scenarios.other	1
где я не зависит	personal_assistant.scenarios.other	1
бакланицы вперед	personal_assistant.scenarios.show_route	1
как доехать улица кирпичная дом 60 город бийск	personal_assistant.scenarios.show_route	1
елагин остров поехали	personal_assistant.scenarios.show_route	1
ломоносов поехали	personal_assistant.scenarios.show_route	1
покажи мне пробки в павловске	personal_assistant.scenarios.show_traffic	1
как проехать до метро нагорная	personal_assistant.scenarios.show_route	1
поехали магазин народный	personal_assistant.scenarios.show_route	1
так да	personal_assistant.scenarios.other	1
дорогу покажи	personal_assistant.scenarios.show_route	1
мастеровой поехали ярослава гашека	personal_assistant.scenarios.show_route	1
ты работает	personal_assistant.scenarios.other	1
x fit платинум	personal_assistant.scenarios.find_poi	1
пробки яндекс 8	personal_assistant.scenarios.show_traffic	1
я смогу включить на просто достать 12	personal_assistant.scenarios.other	1
от ташкента до	personal_assistant.scenarios.show_route	1
космонав	personal_assistant.scenarios.other	1
прибыл	personal_assistant.scenarios.other	1
подождите ой теперь говори	personal_assistant.scenarios.other	1
запчасти двигателя едем в	personal_assistant.scenarios.other	1
алло да	personal_assistant.scenarios.other	1
быстроном	personal_assistant.scenarios.find_poi	1
мое место где сейчас	personal_assistant.scenarios.get_my_location	1
поехали ресторан дрова	personal_assistant.scenarios.show_route	1
и называешь адрес	personal_assistant.scenarios.other	1
пробки на	personal_assistant.scenarios.show_traffic	1
турухтанный	personal_assistant.scenarios.find_poi	1
помолчите	personal_assistant.scenarios.other	1
поймала	personal_assistant.scenarios.other	1
я хочу на машина на машине на машине	personal_assistant.scenarios.other	1
уральская 19 корпус 1 поехали	personal_assistant.scenarios.show_route	1
клуб рядом	personal_assistant.scenarios.find_poi	1
улица трудовые резервы дом 13 поехали	personal_assistant.scenarios.show_route	1
город одинцово улица можайское шоссе дом 139 поехали	personal_assistant.scenarios.show_route	1
пробок 5 баллов	personal_assistant.scenarios.show_traffic	1
ближайшее метро рядом со мной	personal_assistant.scenarios.find_poi	1
илимская 9 поехали	personal_assistant.scenarios.show_route	1
я сейчас где нахожусь	personal_assistant.scenarios.get_my_location	1
бутлерова 12 поехали	personal_assistant.scenarios.show_route	1
ломоносовский про пек	personal_assistant.scenarios.find_poi	1
шахты ростов м 4 пробки есть	personal_assistant.scenarios.show_traffic	1
парковки такси	personal_assistant.scenarios.find_poi	1
едем от чехова улица весенняя 20 до земляной вал 33	personal_assistant.scenarios.show_route	1
поехали староалексеевская	personal_assistant.scenarios.show_route	1
павловский слобода где находится	personal_assistant.scenarios.find_poi	1
google показать пробки в районе	personal_assistant.navi.show_layer	1
школьная 64 поехали	personal_assistant.scenarios.show_route	1
стромиловское шоссе 5 поехали	personal_assistant.scenarios.show_route	1
диво остров стает поехали поехали поехали	personal_assistant.scenarios.other	1
здесь авария скоро будет пробка	personal_assistant.navi.add_point	1
навигатор нам до пахаря хаджи курск метро	personal_assistant.scenarios.show_route	1
находится	personal_assistant.scenarios.other	1
мосина сказать а где я	personal_assistant.scenarios.other	1
ленинский проспект 122	personal_assistant.scenarios.find_poi	1
ближайшая парковка с дизельным топливом	personal_assistant.scenarios.find_poi	1
найди мое местоположение	personal_assistant.scenarios.get_my_location	1
ближайший терминал мкб банк	personal_assistant.scenarios.find_poi	1
что образуется	personal_assistant.scenarios.other	1
едем до химиков 40	personal_assistant.scenarios.show_route	1
мое местоположение город саратов	personal_assistant.scenarios.get_my_location	1
показать камеры на ограничение скорости	personal_assistant.navi.show_layer	1
поехали торговый центр метро	personal_assistant.scenarios.show_route	1
никуда не едем отмена	personal_assistant.navi.reset_route	1
мое местоположение где нахожусь	personal_assistant.scenarios.get_my_location	1
поехали каширское шоссе 63	personal_assistant.scenarios.show_route	1
обнинск поселок дубравушка пионерский проезд 29 маршрут	personal_assistant.scenarios.show_route	1
новодевичий монастырь но через 3 кольцо	personal_assistant.scenarios.show_route	1
если на час там пробка	personal_assistant.scenarios.other	1
что ты говоришь	personal_assistant.scenarios.other	1
метал сервис на карачарово	personal_assistant.scenarios.find_poi	1
построить маршрут до таганской 10	personal_assistant.scenarios.show_route	1
алло да здравствуйте	personal_assistant.scenarios.other	1
парковка оби дом 2 где авария	personal_assistant.scenarios.other	1
здесь пробка	personal_assistant.scenarios.other	1
какие пробки в городе	personal_assistant.scenarios.show_traffic	1
не надо пешком	personal_assistant.scenarios.other	1
покажите где я	personal_assistant.scenarios.get_my_location	1
санаторий искра	personal_assistant.scenarios.find_poi	1
едем от дома до экспофорум	personal_assistant.scenarios.show_route	1
ульяновск через сальск	personal_assistant.scenarios.show_route	1
куда съездить станица	personal_assistant.scenarios.other	1
окей google лихоборская 15 поехали	personal_assistant.scenarios.show_route	1
добавить	personal_assistant.scenarios.other	1
юкко шымкент через тарас	personal_assistant.scenarios.show_route	1
поехали в москву	personal_assistant.scenarios.show_route	1
ивановского 34 поехали	personal_assistant.scenarios.show_route	1
скажите скажите	personal_assistant.scenarios.other	1
магазин лента поблизости	personal_assistant.scenarios.find_poi	1
дпс архив	personal_assistant.scenarios.find_poi	1
поехать выхино на белорусский вокзал	personal_assistant.scenarios.show_route	1
поехали 1 мая 65	personal_assistant.scenarios.show_route	1
где я нахожусь на карте показать	personal_assistant.scenarios.get_my_location	1
все короче 2 занимать	personal_assistant.scenarios.other	1
найди бесплатная парковку	personal_assistant.navi.parking_route	1
город бронницы показать пробки	personal_assistant.scenarios.show_traffic	1
покажите пожалуйста мое местоположение на карте	personal_assistant.scenarios.get_my_location	1
малая балканская 59 поехали	personal_assistant.scenarios.show_route	1
я не знаю я говорю	personal_assistant.scenarios.other	1
ближайшая газа пропан	personal_assistant.scenarios.find_poi	1
что творится	personal_assistant.scenarios.other	1
95 квартал дом 31 поехали	personal_assistant.scenarios.show_route	1
без пробок ломоносова 114	personal_assistant.scenarios.show_route	1
тверская 18 поехали	personal_assistant.scenarios.show_route	1
да поворот налево	personal_assistant.scenarios.other	1
запчасти 1 целая идет от этого и по середине и вот так вот еду до 2 на друга	personal_assistant.scenarios.other	1
яндекс слушай поехали восстания 83	personal_assistant.scenarios.show_route	1
посмотрите до куда пробка	personal_assistant.navi.how_long_traffic_jam	1
все остановить маршрут	personal_assistant.navi.reset_route	1
измениться настройки местоположение	personal_assistant.scenarios.other	1
покажи путь	personal_assistant.navi.show_route_on_map	1
конец пробки	personal_assistant.scenarios.other	1
почта где находится	personal_assistant.scenarios.find_poi	1
через 3 21 отличается	personal_assistant.scenarios.other	1
другой номер не работает пробки	personal_assistant.scenarios.other	1
что ты включился	personal_assistant.scenarios.other	1
покажи мне путь джедаи	personal_assistant.navi.show_route_on_map	1
поехали реутов	personal_assistant.scenarios.show_route	1
ближайший урма	personal_assistant.scenarios.find_poi	1
я где находится встать	personal_assistant.scenarios.other	1
ярославское шоссе 63	personal_assistant.scenarios.find_poi	1
поворот на икшу гуз южного обхода	personal_assistant.scenarios.find_poi	1
дагомыс донская показать пробки	personal_assistant.scenarios.show_traffic	1
поехали челюскинцев 21	personal_assistant.scenarios.show_route	1
поехали икея	personal_assistant.scenarios.show_route	1
девяткино озерная улица через кузьмолово	personal_assistant.scenarios.show_route	1
проложить маршрут дубининская 69	personal_assistant.scenarios.show_route	1
вот получается	personal_assistant.scenarios.other	1
поехать на юрматинская 5	personal_assistant.scenarios.show_route	1
алло алло да да	personal_assistant.scenarios.other	1
деревня столбово проложить маршрут по мкаду	personal_assistant.scenarios.show_route	1
скажите где я стою часа	personal_assistant.scenarios.get_my_location	1
ближайший обмен валюта город москвы	personal_assistant.scenarios.find_poi	1
построить маршрут сторону города дубки	personal_assistant.scenarios.show_route	1
показать на карте место прохождения 2 часа назад	personal_assistant.scenarios.other	1
показать по дороге все заправки отметить	personal_assistant.scenarios.find_poi	1
где камеры	personal_assistant.navi.show_layer	1
поехали советская 115	personal_assistant.scenarios.show_route	1
поехали улица авроры 122	personal_assistant.scenarios.show_route	1
все равно построй	personal_assistant.scenarios.show_route	1
лакшери	personal_assistant.scenarios.other	1
покажи маршрут	personal_assistant.navi.show_route_on_map	1
брехово поехали	personal_assistant.scenarios.show_route	1
помню	personal_assistant.scenarios.other	1
проложить маршрут кишинев улица барбу лэутару 29	personal_assistant.scenarios.show_route	1
обозначить мое местонахождение	personal_assistant.scenarios.get_my_location	1
построить маршрут красногорск	personal_assistant.scenarios.show_route	1
поехали львовский	personal_assistant.scenarios.show_route	1
являются	personal_assistant.scenarios.other	1
назови покажи где я нахожусь	personal_assistant.scenarios.get_my_location	1
камера хранения	personal_assistant.scenarios.find_poi	1
поехали гагарина 2	personal_assistant.scenarios.show_route	1
пробки на дороге работки кстово	personal_assistant.scenarios.show_traffic	1
ближайший иль де ботэ	personal_assistant.scenarios.find_poi	1
яндекс поехали остафьевская 66 корпус 4	personal_assistant.scenarios.show_route	1
выходи	personal_assistant.scenarios.other	1
говорите говоришь куда надо	personal_assistant.scenarios.other	1
где можно припарковаться	personal_assistant.navi.show_layer	1
я где нахожусь	personal_assistant.scenarios.get_my_location	1
разрешение построй	personal_assistant.scenarios.other	1
станция метро каширская поехали	personal_assistant.scenarios.show_route	1
слушай яндекс проложить маршрут белуша 20 б	personal_assistant.scenarios.show_route	1
ближайшая почта	personal_assistant.scenarios.find_poi	1
едем нагорный проезд	personal_assistant.scenarios.show_route	1
бекболата 86 где находится	personal_assistant.scenarios.find_poi	1
google сколько по мкад до московского областного суда	personal_assistant.scenarios.show_route	1
некрасовский рп до лесная 8 а	personal_assistant.scenarios.show_route	1
едем ленсовета 97 сбербанк	personal_assistant.scenarios.show_route	1
ну позвонил	personal_assistant.scenarios.other	1
поехали в рязань	personal_assistant.scenarios.show_route	1
поехали в польшу	personal_assistant.scenarios.show_route	1
где я еду	personal_assistant.scenarios.get_my_location	1
проложить маршрут станица передовая улица горького 140	personal_assistant.scenarios.show_route	1
сколковское шоссе дом 29 поехали	personal_assistant.scenarios.show_route	1
отметить мое местонахождение	personal_assistant.scenarios.other	1
маломосковская 21 поехали	personal_assistant.scenarios.show_route	1
как проехать до скобелевская 19	personal_assistant.scenarios.show_route	1
показать где я нахожусь	personal_assistant.scenarios.get_my_location	1
ну ты скажи	personal_assistant.scenarios.other	1
ты меня уважаемая	personal_assistant.scenarios.other	1
россия где находится	personal_assistant.scenarios.find_poi	1
ничего не работает у нас тоже не работает	personal_assistant.scenarios.other	1
вавилова дом 61 что за пробки	personal_assistant.scenarios.show_route	1
а тут вы так утра	personal_assistant.scenarios.other	1
поехали южные ватутинки футбольная 26	personal_assistant.scenarios.show_route	1
она там пробка	personal_assistant.scenarios.other	1
карпинского 38 проложи маршрут	personal_assistant.scenarios.show_route	1
на химмаш	personal_assistant.scenarios.show_route	1
остановка поворот на красная дуброва	personal_assistant.scenarios.find_poi	1
поехали бисерово балашиха балашиха	personal_assistant.scenarios.show_route	1
богатырский проспект 41 поехали	personal_assistant.scenarios.show_route	1
город саратов через село падинское	personal_assistant.scenarios.show_route	1
что говорить ничего не говори	personal_assistant.scenarios.other	1
улица юбилейная дом 39 корпус 2 доехать	personal_assistant.scenarios.show_route	1
говорите говорите говорите	personal_assistant.scenarios.other	1
ленинский 147 поехали	personal_assistant.scenarios.show_route	1
покажи ближайшую парковку	personal_assistant.navi.show_layer	1
показать пробку	personal_assistant.navi.show_layer	1
поехали пархоменко 25 / 1	personal_assistant.scenarios.show_route	1
нисколько пробок	personal_assistant.scenarios.other	1
нужны припарковаться	personal_assistant.navi.parking_route	1
чертыгашева карманов понять или нет	personal_assistant.scenarios.other	1
поехали на банановая 11 а	personal_assistant.scenarios.show_route	1
пробки показать	personal_assistant.navi.show_layer	1
россия пожалуйста не подскажите компания кирпича занимается	personal_assistant.scenarios.other	1
улица бестужевых дом 3 ехать	personal_assistant.scenarios.show_route	1
я сказала что раньше	personal_assistant.scenarios.other	1
сосала	personal_assistant.scenarios.other	1
ближайший заправка пропан	personal_assistant.scenarios.find_poi	1
здравствуйте можете пожалуйста сделать	personal_assistant.scenarios.other	1
показать все камеры	personal_assistant.navi.show_layer	1
до челябинска	personal_assistant.scenarios.show_route	1
пошла	personal_assistant.scenarios.other	1
зачем налево направо	personal_assistant.scenarios.other	1
проложить маршрут тюменская область поселок багаутдинова	personal_assistant.scenarios.show_route	1
донской проложи маршрут	personal_assistant.scenarios.show_route	1
мое местонахождение покажи	personal_assistant.scenarios.get_my_location	1
скорая приедет	personal_assistant.scenarios.other	1
слушай яндекс показывать стационарные камеры	personal_assistant.navi.show_layer	1
поехали до свободы	personal_assistant.scenarios.show_route	1
ближайшее отделение локо банк	personal_assistant.scenarios.find_poi	1
парковка эвакуированных автомобилей	personal_assistant.scenarios.find_poi	1
сообщение кафе теремок рядом	personal_assistant.navi.add_point	1
чехов московской области поехали	personal_assistant.scenarios.show_route	1
где сейчас я нахожусь	personal_assistant.scenarios.get_my_location	1
поим	personal_assistant.scenarios.other	1
невский проспект дом 57 поехали	personal_assistant.scenarios.show_route	1
истра	personal_assistant.scenarios.find_poi	1
поехали новоясеневский проспект дом 8	personal_assistant.scenarios.show_route	1
ашан университет поехали	personal_assistant.scenarios.show_route	1
авторус по дороге	personal_assistant.scenarios.find_poi	1
что она не знаю	personal_assistant.scenarios.other	1
маршрут на волгоград	personal_assistant.scenarios.show_route	1
заречный указать где камеры переде	personal_assistant.scenarios.other	1
не замужем	personal_assistant.scenarios.other	1
точный адрес где я нахожусь	personal_assistant.scenarios.get_my_location	1
алиса где я нахожусь	personal_assistant.scenarios.get_my_location	1
микрорайон 12 а дом 2 поехали	personal_assistant.scenarios.show_route	1
окей google на ленинградке камеры за скорость	personal_assistant.navi.show_layer	1
показать маршрут на карте	personal_assistant.navi.show_route_on_map	1
поехали советский проспект 33	personal_assistant.scenarios.show_route	1
уральская 172 / 1 едем	personal_assistant.scenarios.show_route	1
город мытищи улица крестьянская посиди до 2 3	personal_assistant.scenarios.find_poi	1
алиса найди место для парковки	personal_assistant.navi.parking_route	1
куда надо говорить	personal_assistant.scenarios.other	1
старая нет проблем	personal_assistant.scenarios.other	1
из кирова до кемерово сколько километр	personal_assistant.scenarios.show_route	1
пробки на москву	personal_assistant.scenarios.show_route	1
расстояние до конца пробки	personal_assistant.navi.how_long_traffic_jam	1
объехать	personal_assistant.navi.show_route_on_map	1
куда артур поехал	personal_assistant.scenarios.other	1
табрис на кубано набережная	personal_assistant.scenarios.find_poi	1
пробки мытищи	personal_assistant.scenarios.show_traffic	1
тк до голицыно калужская область	personal_assistant.scenarios.find_poi	1
авиаторов дом 16 поехали	personal_assistant.scenarios.show_route	1
ленинский 119 поехали	personal_assistant.scenarios.show_route	1
погнали	personal_assistant.scenarios.show_route	1
торговый центр авиапарк проложить маршрут	personal_assistant.scenarios.show_route	1
съездить	personal_assistant.scenarios.other	1
поехали славянск на кубани	personal_assistant.scenarios.show_route	1
поехали к люди	personal_assistant.scenarios.show_route	1
поехали ветеринарная академия	personal_assistant.scenarios.show_route	1
поехали спасская 14 б	personal_assistant.scenarios.show_route	1
алиса скажи где я	personal_assistant.scenarios.get_my_location	1
улица панфилова дом 10 поехали	personal_assistant.scenarios.show_route	1
кучерявенко 5 поехали	personal_assistant.scenarios.show_route	1
говорите что ты хочешь	personal_assistant.scenarios.other	1
улица менделеева дом 56 поехали	personal_assistant.scenarios.show_route	1
таджикистан до москвы сколько километр	personal_assistant.scenarios.show_route	1
маршрут от города от города чехова до города пушкин пушкино	personal_assistant.scenarios.other	1
согласен	personal_assistant.scenarios.other	1
ближайший магазин круглосуточный для грузовой машины мерседес	personal_assistant.scenarios.find_poi	1
найди мне ближайшая парковка	personal_assistant.navi.parking_route	1
васильевский остров 6 линия дом 59 поехали	personal_assistant.scenarios.show_route	1
покажите где находится	personal_assistant.scenarios.other	1
ищи парковку	personal_assistant.navi.parking_route	1
улица братиславская магазин метизы поехали	personal_assistant.scenarios.show_route	1
что за авария впереди	personal_assistant.scenarios.other	1
поиск парковки	personal_assistant.navi.parking_route	1
москва новослободская улица дом 11 поехали	personal_assistant.scenarios.show_route	1
авария в адлере	personal_assistant.navi.add_point	1
аппарат для пополнить счет на компания везет	personal_assistant.scenarios.other	1
краснопутиловская 55 поехали	personal_assistant.scenarios.show_route	1
помоги	personal_assistant.scenarios.other	1
яхтенный 32 через	personal_assistant.scenarios.show_route	1
авиаконструкторов дом 1 поехали	personal_assistant.scenarios.show_route	1
заехать индивидуальная 16	personal_assistant.scenarios.show_route	1
как доехать до спортивной	personal_assistant.scenarios.show_route	1
дачный проспект 27 поехали	personal_assistant.scenarios.show_route	1
показать пробки мкад	personal_assistant.navi.show_layer	1
я ему говорю	personal_assistant.scenarios.other	1
ближайший макдоналдс круглосуточно	personal_assistant.scenarios.find_poi	1
показать где пробки в городе тюмени	personal_assistant.scenarios.show_traffic	1
слушай яндекс очистить все маршруты	personal_assistant.navi.reset_route	1
кондаки от улицы 157 до видного магазин глобус	personal_assistant.scenarios.show_route	1
проложить маршрут поселок каменоломни	personal_assistant.scenarios.show_route	1
разговорчики а вы не подскажите где проходит шахматный турнир	personal_assistant.navi.add_point	1
суворов поехали пенза	personal_assistant.scenarios.show_route	1
тск ская вижу	personal_assistant.scenarios.other	1
что говорить что ли	personal_assistant.scenarios.other	1
поехали санаторий белорусочка	personal_assistant.scenarios.show_route	1
я где	personal_assistant.scenarios.other	1
а что это говорить я не нажимал	personal_assistant.scenarios.other	1
подтвердить	personal_assistant.scenarios.other	1
с той стороны проеду	personal_assistant.scenarios.other	1
я ничего не говори	personal_assistant.scenarios.other	1
отключи парковки	personal_assistant.navi.hide_layer	1
ленина 102 поехали	personal_assistant.scenarios.show_route	1
ремонт бытовой техники и компьютеров	personal_assistant.scenarios.find_poi	1
выкину	personal_assistant.scenarios.other	1
поехали улица правды 58 корпус 4	personal_assistant.scenarios.show_route	1
включи разговорчики	personal_assistant.navi.show_layer	1
пойти пешком	personal_assistant.scenarios.other	1
маршрут владимир москва 2 толмачевский проезд дом 7	personal_assistant.scenarios.show_route	1
есть система октября	personal_assistant.scenarios.other	1
показать маршрут на карте	personal_assistant.navi.show_route_on_map	1
вижу аварию в правом ряду	personal_assistant.navi.add_point	1
слушай яндекс найди меня	personal_assistant.scenarios.get_my_location	1
поставь разговорчики	personal_assistant.navi.add_point	1
как доехать до чернышевск	personal_assistant.scenarios.show_route	1
волоколамский район деревня литвиново построить маршрут	personal_assistant.scenarios.show_route	1
курьянова покажи маршрут	personal_assistant.scenarios.show_route	1
тут 17	personal_assistant.scenarios.other	1
где я сейчас нахожусь	personal_assistant.scenarios.get_my_location	1
юлмарт на яндекс где без пробок	personal_assistant.scenarios.show_route	1
ближайший гис гсп	personal_assistant.scenarios.find_poi	1
правильно	personal_assistant.scenarios.other	1
яндекс поехали на улицу есенина 112	personal_assistant.scenarios.show_route	1
107 должно быть корпус 2	personal_assistant.scenarios.other	1
алые паруса детский оздоровительно образовательный центр где находится	personal_assistant.scenarios.find_poi	1
коломак коломяжский проспект дом 15 корпус 1 проложить маршрут	personal_assistant.scenarios.show_route	1
что говорила	personal_assistant.scenarios.other	1
находилась	personal_assistant.scenarios.other	1
поворот дыдылдино	personal_assistant.scenarios.find_poi	1
вижу ремонтные работы левый ряд	personal_assistant.navi.add_point	1
все включено	personal_assistant.scenarios.other	1
шахуня откуда взялась	personal_assistant.scenarios.other	1
белоозерск проложи маршрут	personal_assistant.scenarios.show_route	1
улица ташкентская 77 поехали	personal_assistant.scenarios.show_route	1
поехали колтушское шоссе 19 корпус 1	personal_assistant.scenarios.show_route	1
запил	personal_assistant.scenarios.other	1
точный адрес где я сейчас нахожусь	personal_assistant.scenarios.get_my_location	1
я хочу тебе перезвоню тебе говорю	personal_assistant.scenarios.other	1
бушовка комплекс поехали	personal_assistant.scenarios.show_route	1
окей google скажи адрес где сейчас нахожусь	personal_assistant.scenarios.get_my_location	1
рядом с улица кулакова кулакова	personal_assistant.scenarios.find_poi	1
едем новлянский 2	personal_assistant.scenarios.show_route	1
оказывается	personal_assistant.scenarios.other	1
лежена 7 / 1	personal_assistant.scenarios.find_poi	1
ахмедли	personal_assistant.scenarios.find_poi	1
пробки трасса новороссийск москва	personal_assistant.scenarios.show_traffic	1
пробки краснодар энем	personal_assistant.scenarios.show_traffic	1
боровляны улица 40 лет победы 23 а проложить маршрут	personal_assistant.scenarios.show_route	1
декабристов 121 поехали	personal_assistant.scenarios.show_route	1
тут все	personal_assistant.scenarios.other	1
покажи где есть пробки	personal_assistant.navi.show_layer	1
включи разговорчики	personal_assistant.navi.show_layer	1
посчитать	personal_assistant.scenarios.other	1
все ага	personal_assistant.scenarios.other	1
а вот возле яблоко я нахожусь	personal_assistant.scenarios.other	1
ханкала чеченская республика	personal_assistant.scenarios.find_poi	1
поехали микрорайон барыбино	personal_assistant.scenarios.show_route	1
через любим	personal_assistant.scenarios.show_route	1
где сейчас находится мой папа	personal_assistant.scenarios.other	1
показать пробки по трассе м 4	personal_assistant.navi.show_layer	1
как нам надо ехать до краснодар	personal_assistant.scenarios.show_route	1
339 дивизия без пробок 27	personal_assistant.scenarios.show_route	1
улица победы московский маршрут	personal_assistant.scenarios.show_route	1
помой сам ближайшая мойка	personal_assistant.scenarios.find_poi	1
пробки фикс прайс	personal_assistant.scenarios.find_poi	1
грузовые парковки	personal_assistant.scenarios.find_poi	1
наверное да да	personal_assistant.scenarios.other	1
я не понимаю что ты говоришь	personal_assistant.scenarios.other	1
ногинск улица декабристов поехали	personal_assistant.scenarios.show_route	1
abc дом где находится	personal_assistant.scenarios.find_poi	1
ближайшая заправка роснефть	personal_assistant.scenarios.find_poi	1
вижу аварию правый ряд	personal_assistant.navi.add_point	1
впереди камера на 40 санкт петербург емельянова 5	personal_assistant.navi.add_point	1
сибиряков гвардейцев 49 а построить маршрут	personal_assistant.scenarios.show_route	1
едем в пушкино	personal_assistant.scenarios.show_route	1
дорожное событие здесь авария	personal_assistant.navi.add_point	1
сколько баллов пробки	personal_assistant.scenarios.show_traffic	1
камера на 60	personal_assistant.navi.add_point	1
что ему скажи	personal_assistant.scenarios.other	1
яндекс поставь разговорчики	personal_assistant.navi.add_point	1
все я не могу	personal_assistant.scenarios.other	1
говорите отсюда	personal_assistant.scenarios.other	1
покажи мне весь маршрут	personal_assistant.navi.show_route_on_map	1
комментарий дороги	personal_assistant.navi.add_point	1
сколько километров ехать до москвы	personal_assistant.scenarios.show_route	1
отменяйте	personal_assistant.scenarios.other	1
не надо будет	personal_assistant.scenarios.other	1
как проехать тверская область старица	personal_assistant.scenarios.show_route	1
подъезжаю	personal_assistant.scenarios.other	1
отмена	personal_assistant.scenarios.other	1
найди парковки	personal_assistant.navi.parking_route	1
я заблудился в лесу мне надо в гости на день рождения	personal_assistant.scenarios.other	1
я где нахажу	personal_assistant.scenarios.get_my_location	1
едем тц алтын т	personal_assistant.scenarios.show_route	1
поехали строителей 28	personal_assistant.scenarios.show_route	1
новый свет маршрут	personal_assistant.scenarios.show_route	1
где пробки около моего дома	personal_assistant.scenarios.show_traffic	1
поворот на зырянка	personal_assistant.scenarios.find_poi	1
автосервис	personal_assistant.scenarios.find_poi	1
подозреваться бюджетных с преступностью сообщество бизнесмен не знаю	personal_assistant.scenarios.other	1
карамова пробок	personal_assistant.scenarios.show_traffic	1
разговорчики	personal_assistant.navi.add_point	1
микрорайон южный дом 8 котельники поехали	personal_assistant.scenarios.show_route	1
поворачивать	personal_assistant.scenarios.other	1
сражайся ка	personal_assistant.scenarios.other	1
чапаева 21 поехали	personal_assistant.scenarios.show_route	1
нежинская дом 9 поехали	personal_assistant.scenarios.show_route	1
химки улица панфилова 1 проложить маршрут	personal_assistant.scenarios.show_route	1
яндекс поехали на новоизмайловский проспект 10	personal_assistant.scenarios.show_route	1
деревня лисавино	personal_assistant.scenarios.find_poi	1
химки до станции	personal_assistant.scenarios.show_route	1
говорите готово	personal_assistant.scenarios.other	1
впереди камера на полосы	personal_assistant.navi.add_point	1
я нахожусь дом 1	personal_assistant.scenarios.other	1
лихой есть пробки	personal_assistant.navi.show_layer	1
построить маршрут от местонахождение совхоз садовая 82	personal_assistant.scenarios.show_route	1
строгинское гаи гибдд	personal_assistant.scenarios.find_poi	1
улица клары цеткин 4 а поехали	personal_assistant.scenarios.show_route	1
поехали академика скрябина дом 80	personal_assistant.scenarios.show_route	1
поехали молодежная 9 семеновка	personal_assistant.scenarios.show_route	1
улица приозерная дом 31	personal_assistant.scenarios.find_poi	1
камера видеонаблюдения	personal_assistant.scenarios.other	1
он может быть	personal_assistant.scenarios.other	1
определить место где я нахожусь	personal_assistant.scenarios.get_my_location	1
напиши	personal_assistant.navi.add_point	1
дорожная 34 корпус 2 поехали уже все	personal_assistant.scenarios.show_route	1
сделай сам	personal_assistant.scenarios.other	1
поворот налево направо	personal_assistant.scenarios.other	1
найти камеры контроля скорости	personal_assistant.navi.show_layer	1
окей google улица токарей есть пробка	personal_assistant.navi.show_layer	1
покажи весь маршрут	personal_assistant.navi.show_route_on_map	1
поехали улица войсковая 20	personal_assistant.scenarios.show_route	1
ты как он называется	personal_assistant.scenarios.other	1
маршрут аэропорт домодедов	personal_assistant.scenarios.show_route	1
ну вот и все	personal_assistant.scenarios.other	1
трасса крымск новороссийск пробки	personal_assistant.scenarios.show_route	1
просторная 71 поехали	personal_assistant.scenarios.show_route	1
строй экспо	personal_assistant.scenarios.find_poi	1
давай заедем лукой чертаново северная	personal_assistant.scenarios.show_route	1
улица дуси ковальчук 250 поехали	personal_assistant.scenarios.show_route	1
вот он показывает	personal_assistant.scenarios.other	1
яндекс покажи пробки	personal_assistant.navi.show_layer	1
погода на сегодня	personal_assistant.scenarios.other	1
построить маршрут до банк восточный экспресс	personal_assistant.scenarios.show_route	1
камеры	personal_assistant.navi.add_point	1
поехали город минск улица маршала лосика дом 31	personal_assistant.scenarios.show_route	1
красноармейское шоссе дом 105 глобус поехали	personal_assistant.scenarios.show_route	1
северни все маршруты	personal_assistant.navi.reset_route	1
маршрут показать букву б	personal_assistant.scenarios.other	1
если на дороге пробки	personal_assistant.scenarios.other	1
что делаешь	personal_assistant.scenarios.other	1
поехали набережная 30	personal_assistant.scenarios.show_route	1
как доехать улица кастанаевская корпус 43	personal_assistant.scenarios.show_route	1
ленина 7 поехали ключево слушай в конце поехали	personal_assistant.scenarios.show_route	1
вижу дтп в правом ряду	personal_assistant.navi.add_point	1
рц монетка поехали	personal_assistant.scenarios.show_route	1
поздравляю	personal_assistant.scenarios.other	1
поехали работа	personal_assistant.scenarios.show_route	1
удалить точку приезда	personal_assistant.scenarios.other	1
поехали на ленина 76	personal_assistant.scenarios.show_route	1
узнать баланс на телефоне	personal_assistant.scenarios.other	1
это говорить на мне показывает	personal_assistant.scenarios.other	1
познакомиться а потом	personal_assistant.scenarios.other	1
перезвоню хорошо	personal_assistant.scenarios.other	1
поставить точку дпс	personal_assistant.navi.add_point	1
поставь заметка	personal_assistant.navi.add_point	1
люблю	personal_assistant.scenarios.other	1
показать пробки на мкад	personal_assistant.scenarios.show_traffic	1
трогай	personal_assistant.scenarios.show_route	1
поехали улица кропоткина дом 77	personal_assistant.scenarios.show_route	1
солнечный шоссе где находится	personal_assistant.scenarios.find_poi	1
забыла 5 / 1	personal_assistant.scenarios.find_poi	1
что обозначает	personal_assistant.scenarios.other	1
мак авто рядом	personal_assistant.scenarios.find_poi	1
что говорить то я не знаю	personal_assistant.scenarios.other	1
студеный овраг смотри сюда	personal_assistant.scenarios.other	1
петлякова поехали	personal_assistant.scenarios.show_route	1
кухаренко	personal_assistant.scenarios.find_poi	1
слышь нескольких местах	personal_assistant.scenarios.other	1
саранинский переулок 3 построить маршрут	personal_assistant.scenarios.show_route	1
когда заработает	personal_assistant.scenarios.other	1
славянская площадь поехали	personal_assistant.scenarios.show_route	1
сабвей да есть хочу	personal_assistant.scenarios.find_poi	1
поехали мира 23 а	personal_assistant.scenarios.show_route	1
танька рядом	personal_assistant.scenarios.find_poi	1
мещовск где находится	personal_assistant.scenarios.find_poi	1
задать новый маршрут	personal_assistant.scenarios.show_route	1
показать мое местоположение на карте	personal_assistant.scenarios.get_my_location	1
как добраться до метро чертаново	personal_assistant.scenarios.show_route	1
измайлова 13 поехали	personal_assistant.scenarios.show_route	1
сумской проезд дом 3 строение 2 поехали	personal_assistant.scenarios.show_route	1
луначарский сбербанк где находится	personal_assistant.scenarios.find_poi	1
едем улица большевитская бани дом 17	personal_assistant.scenarios.show_route	1
григорьева 46 поехали	personal_assistant.scenarios.show_route	1
поехали	personal_assistant.scenarios.show_route	1
ивантеевка максимовка там пробка 6	personal_assistant.scenarios.show_route	1
говорите говорите говорите говорить	personal_assistant.scenarios.other	1
выезжаю	personal_assistant.scenarios.other	1
до пункт петрозаводская улица дом 8	personal_assistant.scenarios.show_route	1
станица калининская заречная 15 а	personal_assistant.scenarios.find_poi	1
планерная 19 корпус 1 маршрут	personal_assistant.scenarios.show_route	1
поехали дорога к дому	personal_assistant.scenarios.show_route	1
красная 202 маршрут для грузовиков	personal_assistant.scenarios.show_route	1
стара загора 159 поехали	personal_assistant.scenarios.show_route	1
зеленый 50 пробок	personal_assistant.scenarios.show_route	1
лиговский проспект 77 поехали	personal_assistant.scenarios.show_route	1
авдон через октябрьский	personal_assistant.scenarios.show_route	1
запустите	personal_assistant.scenarios.other	1
маршрут малая ростока береговая речников 21	personal_assistant.scenarios.show_route	1
поехали толстого 34	personal_assistant.scenarios.show_route	1
пробки богданова	personal_assistant.navi.show_layer	1
где есть пробки	personal_assistant.navi.show_layer	1
определить местонахождение	personal_assistant.scenarios.get_my_location	1
абовян пробок	personal_assistant.scenarios.show_route	1
учхозовского поворот	personal_assistant.scenarios.find_poi	1
поехали кронштадтская 20	personal_assistant.scenarios.show_route	1
холмогорская дом 2 корпус 1 поехали	personal_assistant.scenarios.show_route	1
волжский бульвар дом 8 поехали	personal_assistant.scenarios.show_route	1
краснодарская 60 пробок	personal_assistant.scenarios.show_route	1
3 силикатный проезд поехали	personal_assistant.scenarios.show_route	1
впереди камера 60	personal_assistant.navi.add_point	1
а там еще кусочек	personal_assistant.scenarios.other	1
пробки в воронеже	personal_assistant.scenarios.show_traffic	1
покажи пробки на дорогах	personal_assistant.navi.show_layer	1
где пробки на м 5	personal_assistant.navi.show_layer	1
мое местонахождение на карте	personal_assistant.scenarios.get_my_location	1
где я на	personal_assistant.scenarios.get_my_location	1
объезжайте пробки	personal_assistant.navi.show_route_on_map	1
мое положение на карте данный момент	personal_assistant.scenarios.get_my_location	1
аэропорт кольцово как проехать	personal_assistant.scenarios.show_route	1
другой газпром где находится	personal_assistant.scenarios.find_poi	1
пробка на лиховской мосту	personal_assistant.scenarios.show_traffic	1
построить маршрут алма ата	personal_assistant.scenarios.show_route	1
отметить место нахождения мое	personal_assistant.scenarios.other	1
ближайший фото	personal_assistant.scenarios.find_poi	1
только направо	personal_assistant.scenarios.other	1
парковки на ударников	personal_assistant.navi.show_layer	1
не надо надо	personal_assistant.scenarios.other	1
ну зарабатывай	personal_assistant.scenarios.other	1
снять комнату	personal_assistant.scenarios.other	1
через сколько метров повернуть направо	personal_assistant.scenarios.other	1
хрустальная 2 поехали	personal_assistant.scenarios.show_route	1
от атаманская 53 до песчаная 11 а	personal_assistant.scenarios.show_route	1
где я нахожусь сейчас в волгограде	personal_assistant.scenarios.get_my_location	1
как проехать суворовская	personal_assistant.scenarios.show_route	1
поворот на подольск	personal_assistant.scenarios.find_poi	1
как доехать от балаково до пензы	personal_assistant.scenarios.show_route	1
что делать а	personal_assistant.scenarios.other	1
все правильно говорить	personal_assistant.scenarios.other	1
говори что говорите говорите говорите	personal_assistant.scenarios.other	1
поехать борисовское шоссе дом 1	personal_assistant.scenarios.show_route	1
я уеду говорю	personal_assistant.scenarios.other	1
сколько еще стоять пробки по времени	personal_assistant.navi.how_long_traffic_jam	1
с по урожай 38	personal_assistant.scenarios.show_route	1
впереди авария	personal_assistant.navi.add_point	1
поставь разговорчики	personal_assistant.navi.add_point	1
поехали урицкого 75	personal_assistant.scenarios.show_route	1
так делать чтобы пробок	personal_assistant.scenarios.other	1
улица ростовская 17 без пробок	personal_assistant.scenarios.show_route	1
проложить маршрут до доломановский 70 / 3	personal_assistant.scenarios.show_route	1
вы приехали навигатор	personal_assistant.scenarios.other	1
ага да	personal_assistant.scenarios.other	1
поворот на	personal_assistant.scenarios.other	1
как проехать на таллинский 5	personal_assistant.scenarios.show_route	1
конец маршрута отменить маршрут	personal_assistant.navi.reset_route	1
алло google где я нахожусь	personal_assistant.scenarios.get_my_location	1
маршрут перестроен варшавское шоссе 141 строение 34	personal_assistant.scenarios.other	1
поехали улица липецкая	personal_assistant.scenarios.show_route	1
впереди камера на полосу город реутов улица мира	personal_assistant.navi.add_point	1
где я нахожусь в данное время	personal_assistant.scenarios.get_my_location	1
скажу сейчас	personal_assistant.scenarios.other	1
поехали серебряный переулок 4 строение	personal_assistant.scenarios.show_route	1
сейчас подожди федоровское	personal_assistant.scenarios.other	1
ремонт дороги на правая полоса	personal_assistant.navi.add_point	1
пробка новотек	personal_assistant.navi.show_layer	1
что говорить ничего не	personal_assistant.scenarios.other	1
что случилось	personal_assistant.scenarios.other	1
знаю без тебя	personal_assistant.scenarios.other	1
говори что говорить	personal_assistant.scenarios.other	1
принимают	personal_assistant.navi.add_point	1
город домодедово улица центральная дом 16 поехали	personal_assistant.scenarios.show_route	1
поехали ближайшая пятерочка	personal_assistant.scenarios.find_poi	1
киевский новая сообщение	personal_assistant.navi.add_point	1
музей хлеба с пробками	personal_assistant.scenarios.show_route	1
где камера	personal_assistant.scenarios.other	1
построить маршрут улица тельмана дальневосточный проспект санкт петербург	personal_assistant.scenarios.show_route	1
поехали первомайская 107 а	personal_assistant.scenarios.show_route	1
проложить маршрут ближайший банкомат	personal_assistant.scenarios.show_route	1
шамшиных по деньгам шереметьево	personal_assistant.scenarios.other	1
что тебе сказать что на просто мне сказать почему я говорю	personal_assistant.scenarios.other	1
где камера	personal_assistant.scenarios.other	1
отвези меня в кино	personal_assistant.scenarios.show_route	1
гаишники интересные места под знаком	personal_assistant.navi.add_point	1
пробки на армавир	personal_assistant.scenarios.show_route	1
должна быть машине	personal_assistant.scenarios.other	1
поворот там	personal_assistant.scenarios.other	1
поехали гидра сигнал	personal_assistant.scenarios.show_route	1
покажи разговорчики	personal_assistant.navi.show_layer	1
оксан где нахожусь	personal_assistant.scenarios.get_my_location	1
бери мой	personal_assistant.scenarios.other	1
как доехать садовод	personal_assistant.scenarios.show_route	1
ближайшая автомойка речной	personal_assistant.scenarios.find_poi	1
серегина 39 поехали	personal_assistant.scenarios.show_route	1
где я	personal_assistant.scenarios.get_my_location	1
сели улица силикатная 3 как проехать	personal_assistant.scenarios.show_route	1
я тебе сказал что 2	personal_assistant.scenarios.other	1
яндекс покажи пробки	personal_assistant.navi.show_layer	1
привет яндекс домой	personal_assistant.scenarios.show_route	1
выборгский район поворот на острецово	personal_assistant.scenarios.find_poi	1
найди мне парковку	personal_assistant.navi.parking_route	1
появилась	personal_assistant.scenarios.other	1
точку где я нахожусь	personal_assistant.scenarios.get_my_location	1
показать весь маршрут	personal_assistant.navi.show_route_on_map	1
едем в грибное	personal_assistant.scenarios.show_route	1
сейчас скажу подожди	personal_assistant.scenarios.other	1
поехали улица колхозная дом 31	personal_assistant.scenarios.show_route	1
что то не работает	personal_assistant.scenarios.other	1
поехали ленинский проспект дом 76	personal_assistant.scenarios.show_route	1
этот проехать	personal_assistant.scenarios.other	1
что а не буду говорить	personal_assistant.scenarios.other	1
давай давай ага пока	personal_assistant.scenarios.other	1
поехали воскресенск	personal_assistant.scenarios.show_route	1
управление дпс	personal_assistant.scenarios.find_poi	1
говорите готово говорите	personal_assistant.scenarios.other	1
ты сказала	personal_assistant.scenarios.other	1
да да да я ему говорю что	personal_assistant.scenarios.other	1
тимирязева 65 а поехали	personal_assistant.scenarios.show_route	1
пробки на этом маршруте	personal_assistant.navi.show_route_on_map	1
цветы пробок на 10 с 1	personal_assistant.scenarios.show_route	1
покажите на карте где мы сейчас находимся	personal_assistant.scenarios.get_my_location	1
московская кольцевая дорога внутренняя сторона пробки показать	personal_assistant.navi.show_layer	1
дата знаки стоят	personal_assistant.scenarios.other	1
пробки кострома	personal_assistant.scenarios.show_traffic	1
с краснодара до адыгейская пробки есть	personal_assistant.scenarios.show_route	1
аннеси	personal_assistant.scenarios.find_poi	1
поедем пискаревский 9 корпус 1	personal_assistant.scenarios.show_route	1
я не знаю знаю	personal_assistant.scenarios.other	1
обратиться	personal_assistant.scenarios.other	1
как доехать до мытищи	personal_assistant.scenarios.show_route	1
суздальская 18 г поехали	personal_assistant.scenarios.show_route	1
проложи маршрут рокоссовского	personal_assistant.scenarios.show_route	1
настроить на мою	personal_assistant.scenarios.other	1
покажите где я нахожусь	personal_assistant.scenarios.get_my_location	1
иди ты самая большая пробка	personal_assistant.scenarios.other	1
кетчерская 7 а пробки	personal_assistant.scenarios.show_route	1
восстания 80 а через батыршина 18	personal_assistant.scenarios.show_route	1
дтп	personal_assistant.navi.add_point	1
едем ленина 55 красногорск	personal_assistant.scenarios.show_route	1
нет не пищевых технологий московский университет технологии и управления	personal_assistant.scenarios.find_poi	1
какая то я не знаю	personal_assistant.scenarios.other	1
кордай это было	personal_assistant.scenarios.other	1
местоположение мое	personal_assistant.scenarios.get_my_location	1
поставь пробки	personal_assistant.navi.show_layer	1
поехали с 1	personal_assistant.scenarios.show_route	1
показать пробки на пошехонка	personal_assistant.scenarios.show_traffic	1
я же сказал что то	personal_assistant.scenarios.other	1
поехали 2 новоостанкинская улица дом 12	personal_assistant.scenarios.show_route	1
направо показывает	personal_assistant.scenarios.other	1
нарисовать дорогу	personal_assistant.scenarios.other	1
ага лесной	personal_assistant.scenarios.other	1
оружейная 15 поехали	personal_assistant.scenarios.show_route	1
найди мне парковку рядом	personal_assistant.navi.parking_route	1
построить маршрут улица камышовая дом 22 корпус 1	personal_assistant.scenarios.show_route	1
основное там осталось	personal_assistant.scenarios.other	1
проложить маршрут дюртюли	personal_assistant.scenarios.show_route	1
добавить точку	personal_assistant.navi.add_point	1
микрофон и говоришь	personal_assistant.scenarios.other	1
впереди камера на полосы куркинское шоссе 18	personal_assistant.navi.add_point	1
нижний новгород чаадаева 3 б поехали	personal_assistant.scenarios.show_route	1
гражданский проспект 55 поехали	personal_assistant.scenarios.show_route	1
хользунова 78 б маршрут	personal_assistant.scenarios.show_route	1
пилотов 38 поехали	personal_assistant.scenarios.show_route	1
поликлиника номер 1 поехали	personal_assistant.scenarios.show_route	1
слушай яндекс по какой улице я нахожусь	personal_assistant.scenarios.get_my_location	1
поехали ленина 107	personal_assistant.scenarios.show_route	1
положить деньги на телефон	personal_assistant.scenarios.other	1
показать пробки на маршруте	personal_assistant.navi.show_route_on_map	1
добавить точку	personal_assistant.navi.add_point	1
слушай яндекс найди парковку	personal_assistant.navi.parking_route	1
донер поблизости	personal_assistant.scenarios.find_poi	1
а куда хочешь	personal_assistant.scenarios.other	1
алло здравствуйте это акушерства	personal_assistant.scenarios.other	1
где я сейчас находится	personal_assistant.scenarios.get_my_location	1
как включить	personal_assistant.scenarios.other	1
говорить поехали на минеево 9	personal_assistant.scenarios.show_route	1
едем улица ляпидевского	personal_assistant.scenarios.show_route	1
включить разговорный	personal_assistant.navi.show_layer	1
показать где я нахожусь	personal_assistant.scenarios.get_my_location	1
ближайший магазин гиперавто	personal_assistant.scenarios.find_poi	1
маршрут до проспект шолохова дом 310 а	personal_assistant.scenarios.show_route	1
банк банкоматы	personal_assistant.scenarios.find_poi	1
часовая 2 90 большая она там выдает средняя скорость	personal_assistant.scenarios.other	1
тачен	personal_assistant.scenarios.find_poi	1
пробки на трассе дон 4	personal_assistant.navi.show_layer	1
ближайшая бензозаправка газпром	personal_assistant.scenarios.find_poi	1
поехали 24 северная 190	personal_assistant.scenarios.show_route	1
есть такой же кубик	personal_assistant.scenarios.other	1
ты знаешь езди без пробок	personal_assistant.scenarios.other	1
причина пробки	personal_assistant.scenarios.other	1
улица поварская дом 20 поехали	personal_assistant.scenarios.show_route	1
заканчивается	personal_assistant.scenarios.other	1
покажите мое местоположение	personal_assistant.scenarios.get_my_location	1
покажите камеры	personal_assistant.navi.show_layer	1
перекрывают	personal_assistant.scenarios.other	1
до 4	personal_assistant.scenarios.other	1
мильково дорогу покажи	personal_assistant.scenarios.show_route	1
ростов на дону поехали	personal_assistant.scenarios.show_route	1
сейчас попробую перезвоню	personal_assistant.scenarios.other	1
билайн поблизости	personal_assistant.scenarios.find_poi	1
проложи маршрут усово 3 тупик	personal_assistant.scenarios.show_route	1
говорите забыл	personal_assistant.scenarios.other	1
улица сормовская построй маршрут	personal_assistant.scenarios.show_route	1
где пробка заканчивается сторону арзамаса	personal_assistant.navi.how_long_traffic_jam	1
яндекс построй маршрут до 1 казахстанская 9 / 1	personal_assistant.scenarios.show_route	1
микрорайон 12 а 2 в поехали	personal_assistant.scenarios.show_route	1
какая пробка 90	personal_assistant.scenarios.other	1
напиши руками богатые сабы	personal_assistant.scenarios.other	1
сфотографироваться с памятником мамонтов	personal_assistant.scenarios.other	1
да конечно конечно	personal_assistant.scenarios.other	1
судогда поехали	personal_assistant.scenarios.show_route	1
ростов на дону через воронеж	personal_assistant.scenarios.show_route	1
построить маршрут улица дубининская дом 27 строение 1	personal_assistant.scenarios.show_route	1
иногда ошибаюсь	personal_assistant.scenarios.other	1
там называется торговая	personal_assistant.scenarios.other	1
сбросить пробки	personal_assistant.navi.hide_layer	1
скажите где я сейчас нахожусь	personal_assistant.scenarios.get_my_location	1
через российская индустриальная	personal_assistant.scenarios.show_route	1
показать где я	personal_assistant.scenarios.get_my_location	1
пробок	personal_assistant.scenarios.show_traffic	1
аэропорт пашковский	personal_assistant.scenarios.find_poi	1
черницынский проезд дом 10 корпус 2 подъезд 5 поехали	personal_assistant.scenarios.show_route	1
покажи пробки по маршруту	personal_assistant.navi.show_layer	1
яндекс покажи где я нахожусь	personal_assistant.scenarios.get_my_location	1
проложи маршрут большой златоустинский переулок дом 5 в москве	personal_assistant.scenarios.show_route	1
посиди	personal_assistant.scenarios.other	1
от валдая до санкт петербурга	personal_assistant.scenarios.show_route	1
отдел мвд	personal_assistant.scenarios.find_poi	1
удалить маршруты	personal_assistant.navi.reset_route	1
поехали юных ленинцев 89 корпус 1	personal_assistant.scenarios.show_route	1
51 градус 48 минут 0 54 секунды северной широты 39° 11 минут 674 секунд восточной долготы	personal_assistant.scenarios.find_poi	1
нормально дорогу есть поселок	personal_assistant.scenarios.other	1
потише сделай	personal_assistant.scenarios.other	1
и он просил сделать так помочь	personal_assistant.scenarios.other	1
балаклавский проспект дом 1 поехали	personal_assistant.scenarios.show_route	1
ближайшая автомобильная газовая заправка пропан бутан	personal_assistant.scenarios.find_poi	1
алло да да	personal_assistant.scenarios.other	1
говорите пишет	personal_assistant.scenarios.other	1
показать дорогу до ленина	personal_assistant.scenarios.show_route	1
поставь бурчик	personal_assistant.scenarios.other	1
я говорю налево направо потом что это будет	personal_assistant.scenarios.other	1
яндекс ближайший отель	personal_assistant.scenarios.find_poi	1
поехали на уральской 69	personal_assistant.scenarios.show_route	1
ближайший супермаркет 24	personal_assistant.scenarios.find_poi	1
корпус 5 а где подземная парковка	personal_assistant.scenarios.find_poi	1
не могу понять что это за	personal_assistant.scenarios.other	1
метро планерная маршрут	personal_assistant.scenarios.show_route	1
говорите говоришь куда	personal_assistant.scenarios.other	1
смотрели там смотрели там	personal_assistant.scenarios.other	1
долгопрудный дирижабельная улица 15 б ехать	personal_assistant.scenarios.show_route	1
едем канаш чкалова 1 а	personal_assistant.scenarios.show_route	1
поехали 2 строительный переулок 17	personal_assistant.scenarios.show_route	1
сейчас я не знаю	personal_assistant.scenarios.other	1
пробки на м 4 из миллерово до новошахтинска есть	personal_assistant.scenarios.show_route	1
покажи пробки яндекс	personal_assistant.navi.show_layer	1
предупреждать пробки	personal_assistant.scenarios.show_traffic	1
самый ближайший хостел в москве	personal_assistant.scenarios.find_poi	1
знаешь	personal_assistant.scenarios.other	1
построй маршрут до улицы ленина дом 8	personal_assistant.scenarios.show_route	1
ростов на дону самый ближайший путь	personal_assistant.scenarios.show_route	1
нам не пишет говорить я не могу	personal_assistant.scenarios.other	1
окей google где я был	personal_assistant.scenarios.other	1
где самые большие пробки	personal_assistant.scenarios.other	1
ходынский бульвар 17 поехали	personal_assistant.scenarios.show_route	1
да иди на	personal_assistant.scenarios.other	1
поехали невский 24	personal_assistant.scenarios.show_route	1
мое местонахождение где я нахожусь	personal_assistant.scenarios.get_my_location	1
скажите 6	personal_assistant.scenarios.other	1
ближайший туалет бесплатно	personal_assistant.scenarios.find_poi	1
сколько баллов пробки м 4 дон	personal_assistant.scenarios.show_traffic	1
вот работает нет	personal_assistant.scenarios.other	1
ближайший парикмахерская	personal_assistant.scenarios.find_poi	1
реутовских ополченцев 8 поехали	personal_assistant.scenarios.show_route	1
поехали шестаковская 3	personal_assistant.scenarios.show_route	1
пробки в саратове	personal_assistant.scenarios.show_traffic	1
большой мое местоположение	personal_assistant.scenarios.get_my_location	1
призма нет я знаю	personal_assistant.scenarios.other	1
ленинский проспект 16 поехали	personal_assistant.scenarios.show_route	1
поехали алтай гостиница	personal_assistant.scenarios.show_route	1
поставь разговорчики почему стоит	personal_assistant.navi.add_point	1
автомобиль на машина с пробегом	personal_assistant.scenarios.other	1
ближайший магазин леруа	personal_assistant.scenarios.find_poi	1
поехали улица чернореченская 21	personal_assistant.scenarios.show_route	1
показать дорогу сходня	personal_assistant.scenarios.show_route	1
почему я должна	personal_assistant.scenarios.other	1
не видно	personal_assistant.scenarios.other	1
пробки по трассе м 4	personal_assistant.navi.show_layer	1
шенген так называется	personal_assistant.scenarios.other	1
ему сказать	personal_assistant.scenarios.other	1
где ближайшая камера	personal_assistant.scenarios.other	1
что ты молчишь	personal_assistant.scenarios.other	1
максима горького 17 поехать	personal_assistant.scenarios.show_route	1
обзор маршрута	personal_assistant.navi.show_route_on_map	1
ближайшая азс еко	personal_assistant.scenarios.find_poi	1
разберемся	personal_assistant.scenarios.other	1
показать где я стою	personal_assistant.scenarios.get_my_location	1
на июнь	personal_assistant.scenarios.other	1
абытаевская 4 а маршрут	personal_assistant.scenarios.show_route	1
ближайший терминал сбербанка	personal_assistant.scenarios.find_poi	1
владимирская 34 поехали	personal_assistant.scenarios.show_route	1
я сейчас посмотрю просто скажу	personal_assistant.scenarios.other	1
авария в левом ряду дмитровский проезд	personal_assistant.navi.add_point	1
куда мы сегодня уезжаем скажите мне пожалуйста	personal_assistant.scenarios.other	1
говорите все нормально	personal_assistant.scenarios.other	1
слушай навигатор как доехать до марксистской 7	personal_assistant.scenarios.show_route	1
сейчас направо повернуть	personal_assistant.scenarios.other	1
у нас это показывает а	personal_assistant.scenarios.other	1
едем до тулы	personal_assistant.scenarios.show_route	1
смоленская метро поехали	personal_assistant.scenarios.show_route	1
оксана где я нахожусь	personal_assistant.scenarios.get_my_location	1
ну что говорить	personal_assistant.scenarios.other	1
через телефон	personal_assistant.scenarios.other	1
организуем	personal_assistant.scenarios.other	1
я могу я не могу просто объясните 3	personal_assistant.scenarios.other	1
поехали на улицу цветочная 198	personal_assistant.scenarios.show_route	1
набери на безрыбье хвост рыбное	personal_assistant.scenarios.other	1
дорога едет	personal_assistant.scenarios.other	1
здравствуй яндекс мое местоположение	personal_assistant.scenarios.get_my_location	1
50 лет влксм 12 поехали	personal_assistant.scenarios.show_route	1
изменить вид карты на спутник	personal_assistant.navi.show_layer	1
я написала из	personal_assistant.scenarios.other	1
поехали карла маркса 111	personal_assistant.scenarios.show_route	1
улица саляма адиля дом 2 корпус 1 поехали	personal_assistant.scenarios.show_route	1
едем до брянского районного суда	personal_assistant.scenarios.show_route	1
отмена маршрут пожалуйста	personal_assistant.navi.reset_route	1
пробки на мкад	personal_assistant.navi.show_layer	1
поехали на ушакова дом 70	personal_assistant.scenarios.show_route	1
бульвар новаторов 24 44 без пробок	personal_assistant.scenarios.show_route	1
поехали движок	personal_assistant.scenarios.show_route	1
деревня сорокино улица береговая 33 а поехали	personal_assistant.scenarios.show_route	1
рц радумля	personal_assistant.scenarios.find_poi	1
поехали на паркинг	personal_assistant.navi.parking_route	1
а что за что все я вам скажите	personal_assistant.scenarios.other	1
открылся	personal_assistant.scenarios.other	1
профсоюзная 44 корпус 1 поехали	personal_assistant.scenarios.show_route	1
едем бабушка	personal_assistant.scenarios.show_route	1
ехать до оренбурга	personal_assistant.scenarios.show_route	1
это где находится	personal_assistant.scenarios.find_poi	1
алло да здравствуйте беспокою	personal_assistant.scenarios.other	1
окей google я геде подскажите мое местоположение	personal_assistant.scenarios.get_my_location	1
бетанкура 1 яндекс пробки 8 баллов	personal_assistant.scenarios.other	1
город пушкино макдональдс построить маршрут	personal_assistant.scenarios.show_route	1
поехали плотникова дом 1	personal_assistant.scenarios.show_route	1
который встречать	personal_assistant.scenarios.other	1
улица марата 29 поехали	personal_assistant.scenarios.show_route	1
позвони	personal_assistant.scenarios.other	1
google где я нахожусь	personal_assistant.scenarios.get_my_location	1
проложить маршрут нижний новгород дзержинск м 7 378 километр азс лукойл	personal_assistant.scenarios.show_route	1
поехали 23 северная 89	personal_assistant.scenarios.show_route	1
место где мы находимся	personal_assistant.scenarios.get_my_location	1
выехать парковки	personal_assistant.scenarios.other	1
поехали на первомайской 25	personal_assistant.scenarios.show_route	1
установить метку камера	personal_assistant.navi.add_point	1
поехали город климовск улица ленина дом 20	personal_assistant.scenarios.show_route	1
окей	personal_assistant.scenarios.other	1
поехали вашутинское шоссе владение 7	personal_assistant.scenarios.show_route	1
улица лескова дом 5 без пробок	personal_assistant.scenarios.show_route	1
куда направлена	personal_assistant.scenarios.other	1
так понимаю на м 4	personal_assistant.scenarios.other	1
ближайший автовокзал	personal_assistant.scenarios.find_poi	1
доехать до замка коварства и любви	personal_assistant.scenarios.show_route	1
отрарская 21 алматы маршрут	personal_assistant.scenarios.show_route	1
ближайший кредит европа банк автомат	personal_assistant.scenarios.find_poi	1
айнабулак поворот	personal_assistant.scenarios.find_poi	1
красное село поехали	personal_assistant.scenarios.show_route	1
улица генерала алексеева строение 42 до 3	personal_assistant.scenarios.find_poi	1
построить маршрут кузнецова 27	personal_assistant.scenarios.show_route	1
грибаново пробки	personal_assistant.scenarios.show_traffic	1
найти местонахождение	personal_assistant.scenarios.get_my_location	1
как поехать пробки	personal_assistant.navi.show_route_on_map	1
ближайшая азс шел	personal_assistant.scenarios.find_poi	1
кирпич а ну сейчас я вот хотел евросеть	personal_assistant.scenarios.other	1
ты знаешь	personal_assistant.scenarios.other	1
найти где мы находимся	personal_assistant.scenarios.get_my_location	1
заходишь туда	personal_assistant.scenarios.other	1
да хорошо	personal_assistant.scenarios.other	1
теперь говори	personal_assistant.scenarios.other	1
лежена 7 / 1	personal_assistant.scenarios.find_poi	1
а ну да	personal_assistant.scenarios.other	1
тебе перезвоню	personal_assistant.scenarios.other	1
говоришь куда допустим	personal_assistant.scenarios.other	1
все поняла	personal_assistant.scenarios.other	1
адмирала 3% при палата представителей костычева начнется отчет его 2 40	personal_assistant.scenarios.other	1
слушай яндекс где я сейчас нахожусь	personal_assistant.scenarios.get_my_location	1
улица академика пилюгина дом 4 поехали	personal_assistant.scenarios.show_route	1
идите	personal_assistant.scenarios.other	1
напиши давай 87	personal_assistant.scenarios.other	1
точный адрес моего местонахождение	personal_assistant.scenarios.get_my_location	1
москва через волово липецкой области	personal_assistant.scenarios.show_route	1
яндекс поехали тимирязева 11	personal_assistant.scenarios.show_route	1
окей яндекс построить маршрут ульяновск рязань	personal_assistant.scenarios.show_route	1
через тахтамукай	personal_assistant.scenarios.show_route	1
6 рощинский проезд дом 1 поехали	personal_assistant.scenarios.show_route	1
северное чертаново 3 поехали	personal_assistant.scenarios.show_route	1
улица хошимина дом 6 маршрут	personal_assistant.scenarios.show_route	1
радио 24 корпус 1 поехали	personal_assistant.scenarios.show_route	1
есть ли пробки до шереметьево	personal_assistant.scenarios.show_route	1
корпус 1 до 1000000000	personal_assistant.scenarios.other	1
ремонт компьютеров и сотовых	personal_assistant.scenarios.find_poi	1
город донецк ростовская область пробки	personal_assistant.scenarios.show_route	1
авиаконструктора микояна 14 корпус 3 поехали	personal_assistant.scenarios.show_route	1
я где находится	personal_assistant.scenarios.get_my_location	1
поедем 34 показать пробки	personal_assistant.scenarios.other	1
ашан где находится	personal_assistant.scenarios.find_poi	1
как объехать эту пробку	personal_assistant.navi.show_route_on_map	1
где я найди меня	personal_assistant.scenarios.get_my_location	1
говори сегодня	personal_assistant.scenarios.other	1
ремонт дороги кореновск	personal_assistant.navi.add_point	1
тбилисская 13 поехали	personal_assistant.scenarios.show_route	1
поехали усиевича 20 корпус 1	personal_assistant.scenarios.show_route	1
поехали улица новая жизнь 6	personal_assistant.scenarios.show_route	1
дорожные работы большая купальная	personal_assistant.navi.add_point	1
улица волгоградская 40 до улицы военная 15	personal_assistant.scenarios.show_route	1
высоковольтный проезд 1 строение 24 поехали	personal_assistant.scenarios.show_route	1
напиши сообщение	personal_assistant.navi.add_point	1
ближайший леруа	personal_assistant.scenarios.find_poi	1
бухарестская 94 корпус 2 поехали	personal_assistant.scenarios.show_route	1
говорите куда едем	personal_assistant.scenarios.other	1
гниет пробок	personal_assistant.scenarios.other	1
тополиная 29 поехали	personal_assistant.scenarios.show_route	1
заехать метро багратионовская багратионовский проезд дом 7	personal_assistant.scenarios.show_route	1
дорога в сернур через ашан	personal_assistant.scenarios.show_route	1
здесь по газу боброво	personal_assistant.scenarios.other	1
где находится	personal_assistant.scenarios.other	1
терекли	personal_assistant.scenarios.find_poi	1
проложи маршрут до айская 48	personal_assistant.scenarios.show_route	1
я скажу 1	personal_assistant.scenarios.other	1
где стоят камеры	personal_assistant.navi.show_layer	1
сколько километров селение чикола ирафский района до прохладного	personal_assistant.scenarios.show_route	1
московская область истринский район павловская слобода улица ленина проложить маршрут	personal_assistant.scenarios.show_route	1
иди на кухню	personal_assistant.scenarios.other	1
где мы сейчас находимся	personal_assistant.scenarios.get_my_location	1
куда на покажи	personal_assistant.scenarios.other	1
вот въезжаю туда	personal_assistant.scenarios.other	1
где я нахожусь что за район	personal_assistant.scenarios.get_my_location	1
ситадел	personal_assistant.scenarios.find_poi	1
поехали анализ рижская и безопасности	personal_assistant.scenarios.show_route	1
окей google как доехать до метро красногвардейская	personal_assistant.scenarios.show_route	1
скажите мне пожалуйста пожалуйста скажи	personal_assistant.scenarios.other	1
подождите говорите	personal_assistant.scenarios.other	1
ехать по зсд до богатырского проспекта	personal_assistant.scenarios.show_route	1
короткова 51 а поехали	personal_assistant.scenarios.show_route	1
что стоит	personal_assistant.scenarios.other	1
а что говорить то	personal_assistant.scenarios.other	1
москва чебоксары трасса показать с пробками	personal_assistant.scenarios.show_route	1
москва коновалова 5 без пробок	personal_assistant.scenarios.show_route	1
левом ряду снеговой	personal_assistant.navi.add_point	1
газопровод 6 корпус б поехали	personal_assistant.scenarios.show_route	1
установить на таксометр	personal_assistant.scenarios.other	1
самомой мойка на мкаде ближайший	personal_assistant.scenarios.find_poi	1
я не говорю	personal_assistant.scenarios.other	1
краси 86 / 1	personal_assistant.scenarios.find_poi	1
расстояние до поворота на даче	personal_assistant.scenarios.other	1
киров ботинки у нас ездил все отработанное	personal_assistant.scenarios.other	1
а что сказать	personal_assistant.scenarios.other	1
на сколько времени пробка	personal_assistant.navi.how_long_traffic_jam	1
улица ленинского комсомола 68 корпус 3 поехали	personal_assistant.scenarios.show_route	1
точное местонахождение где я нахожусь	personal_assistant.scenarios.get_my_location	1
36 динамовский проезд 32 поехали	personal_assistant.scenarios.show_route	1
союзный проспект дом 10 едем	personal_assistant.scenarios.show_route	1
проложить маршрут до город копыль площадь ленина	personal_assistant.scenarios.show_route	1
пробки сулин	personal_assistant.scenarios.show_traffic	1
поехали улица героев панфиловцев 16 корпус 1	personal_assistant.scenarios.show_route	1
все приехали	personal_assistant.scenarios.other	1
сюда до машины	personal_assistant.scenarios.other	1
до направо прямо и косинская улица дом стоит косинская 7 20 корпус 17	personal_assistant.scenarios.other	1
лежена 22 / 1	personal_assistant.scenarios.find_poi	1
новочеркасский проспект дом 1 поехали	personal_assistant.scenarios.show_route	1
идем пешком	personal_assistant.scenarios.other	1
ближайший ашан на шоссе энтузиастов	personal_assistant.scenarios.find_poi	1
пробки 19	personal_assistant.scenarios.show_traffic	1
что как забить	personal_assistant.scenarios.other	1
обновить	personal_assistant.navi.show_route_on_map	1
описать	personal_assistant.scenarios.other	1
лиховской мост пробки	personal_assistant.scenarios.show_traffic	1
кулгали 15 / 21	personal_assistant.scenarios.find_poi	1
старый амбар на адель кутуя	personal_assistant.scenarios.find_poi	1
где я живу	personal_assistant.scenarios.find_poi	1
голосовое сообщение есть	personal_assistant.scenarios.other	1
как проехать на улицу степана злобина 26	personal_assistant.scenarios.show_route	1
и говорю	personal_assistant.scenarios.other	1
тимирязевская 30 корпус 1 поехали	personal_assistant.scenarios.show_route	1
ходят	personal_assistant.scenarios.other	1
дпс 58	personal_assistant.scenarios.find_poi	1
раменки 5 поехали	personal_assistant.scenarios.show_route	1
терминал оплаты парковки поэтому адресу	personal_assistant.scenarios.find_poi	1
пакачи	personal_assistant.scenarios.other	1
автосалон фольцваген ближайший	personal_assistant.scenarios.find_poi	1
алло да нет это григорий григорьевич да	personal_assistant.scenarios.other	1
поехали проспект ленина 76	personal_assistant.scenarios.show_route	1
построить маршрут сидорово ступинский район московской области	personal_assistant.scenarios.show_route	1
поставить точку камера	personal_assistant.navi.add_point	1
студенческая 18 поехали	personal_assistant.scenarios.show_route	1
яндекс пробки	personal_assistant.scenarios.show_traffic	1
не хочу говорить отстань	personal_assistant.scenarios.other	1
определи	personal_assistant.scenarios.other	1
мой адрес где я нахожусь	personal_assistant.scenarios.get_my_location	1
не можно	personal_assistant.scenarios.other	1
улица окружная дом 6 поехали	personal_assistant.scenarios.show_route	1
доехать до москвы улица одесская	personal_assistant.scenarios.show_route	1
пожалуйста да	personal_assistant.scenarios.other	1
сюда направо	personal_assistant.scenarios.other	1
поехали ленинградское шоссе 120 корпус 3	personal_assistant.scenarios.show_route	1
google как проехать полотняный завод	personal_assistant.scenarios.show_route	1
куда микрофон говорите	personal_assistant.scenarios.other	1
пробки москва	personal_assistant.scenarios.show_traffic	1
учетом пробок	personal_assistant.scenarios.other	1
денисовский переулок дом 3 2 / 5 поехали	personal_assistant.scenarios.show_route	1
да ладно	personal_assistant.scenarios.other	1
камеры контроля полосы	personal_assistant.navi.add_point	1
московская область город химки микрорайон левобережный улица совхозная дом 16 корпус 2 подъезд 4 через мкад	personal_assistant.scenarios.show_route	1
улица мира 102 поехали	personal_assistant.scenarios.show_route	1
нефтяников 3 нефтестрой город ярославль поехали	personal_assistant.scenarios.show_route	1
почему не не говорите куда поворачивать	personal_assistant.scenarios.other	1
вернадского показать маршрут	personal_assistant.scenarios.show_route	1
едем до улицы тверская 16	personal_assistant.scenarios.show_route	1
ты скажи	personal_assistant.scenarios.other	1
что есть пробки	personal_assistant.scenarios.show_traffic	1
пробки за ростовом показывай	personal_assistant.scenarios.show_traffic	1
ближайшие пробки	personal_assistant.navi.show_layer	1
улица механизатор 2 абрикосовая 108 поехали	personal_assistant.scenarios.show_route	1
чечерский проезд не знаю	personal_assistant.scenarios.find_poi	1
тут 25	personal_assistant.scenarios.other	1
камера поток	personal_assistant.navi.add_point	1
улица полярная дом 2 поехали	personal_assistant.scenarios.show_route	1
вести голосом маква рейдера	personal_assistant.navi.change_voice	1
не надо нам крутой поворот налево	personal_assistant.scenarios.other	1
едем до московские ворота	personal_assistant.scenarios.show_route	1
пробки краснодар	personal_assistant.scenarios.show_traffic	1
поехали жк риверсайд	personal_assistant.scenarios.show_route	1
где я был	personal_assistant.scenarios.other	1
протяженность пробки сколько километров	personal_assistant.navi.how_long_traffic_jam	1
моя местоположение	personal_assistant.scenarios.get_my_location	1
ага да есть такая то есть	personal_assistant.scenarios.other	1
слушай яндекс местоположение мое	personal_assistant.scenarios.get_my_location	1
алма атинский где находится	personal_assistant.scenarios.find_poi	1
построить маршрут реутов	personal_assistant.scenarios.show_route	1
59° 49 0 23 минут минут и 30° 30 минут 0 94 минут e	personal_assistant.scenarios.find_poi	1
вы приехали банк	personal_assistant.scenarios.other	1
проехать улица кузнецова 2	personal_assistant.scenarios.show_route	1
заправка где находится	personal_assistant.scenarios.find_poi	1
гоголь покажи дорогу	personal_assistant.scenarios.show_route	1
пробки на работу	personal_assistant.scenarios.show_route	1
щепкина 33 поехали	personal_assistant.scenarios.show_route	1
почтовая 283 трудовая улица подъезжаю нажимаю нахожусь где я	personal_assistant.scenarios.other	1
стопани 33 поехали стопани 33	personal_assistant.scenarios.show_route	1
на автовокзал дорога покажите	personal_assistant.scenarios.show_route	1
мира 144 а поехали	personal_assistant.scenarios.show_route	1
покажите мне где где есть пробки	personal_assistant.navi.show_layer	1
азс ближайший	personal_assistant.scenarios.find_poi	1
казанский 41 сейчас подожди	personal_assistant.scenarios.other	1
показать мое месторасположение	personal_assistant.scenarios.get_my_location	1
ну понимаю	personal_assistant.scenarios.other	1
отмена маршрута	personal_assistant.navi.reset_route	1
стара загора 56 маршрут	personal_assistant.scenarios.show_route	1
ближайший магазин инструментов	personal_assistant.scenarios.find_poi	1
пробки москва	personal_assistant.scenarios.show_traffic	1
поворот военный городок	personal_assistant.scenarios.find_poi	1
я нахожусь в данный момент поэтому адресу	personal_assistant.scenarios.get_my_location	1
показать пробки на краснодар через крымск	personal_assistant.scenarios.show_route	1
пробок нет ничего	personal_assistant.scenarios.other	1
ездил	personal_assistant.scenarios.other	1
город горячий ключ краснодар пробки на дорогах	personal_assistant.scenarios.show_route	1
одоевского 1 поехали	personal_assistant.scenarios.show_route	1
поехали на заслонова 5	personal_assistant.scenarios.show_route	1
теннисный клуб удар поехали	personal_assistant.scenarios.show_route	1
пробки на ленинградке	personal_assistant.scenarios.show_traffic	1
университетская набережная 22 поехали	personal_assistant.scenarios.show_route	1
северная 62 поехали	personal_assistant.scenarios.show_route	1
поехали адоратского 23	personal_assistant.scenarios.show_route	1
как поехать на работу на работу	personal_assistant.scenarios.show_route	1
ближайший автосалон ниссан	personal_assistant.scenarios.find_poi	1
скажите где я нахожусь не нужен магазин глория джинс	personal_assistant.scenarios.other	1
поехали до деревня сергеевка	personal_assistant.scenarios.show_route	1
сбербанковский банкомат	personal_assistant.scenarios.find_poi	1
гоголя жумалиева поехали	personal_assistant.scenarios.show_route	1
маршрут от евпатории до ростова	personal_assistant.scenarios.show_route	1
жд вокзал добраться без пробок	personal_assistant.scenarios.show_route	1
проложи маршрут шахты победы революции 120	personal_assistant.scenarios.show_route	1
скрыть пробки	personal_assistant.navi.hide_layer	1
гаражи перед въездом буду ждать	personal_assistant.scenarios.other	1
поехали улица братиславская дом 18 корпус 1	personal_assistant.scenarios.show_route	1
днепра камера говори	personal_assistant.scenarios.other	1
поехали в адлер	personal_assistant.scenarios.show_route	1
составить маршрут из новозавидово в город казань	personal_assistant.scenarios.show_route	1
полиграфическая детский парк построить дорогу	personal_assistant.scenarios.show_route	1
говорите зачем	personal_assistant.scenarios.other	1
найти местоположение	personal_assistant.scenarios.get_my_location	1
дорожные работы средний ряд	personal_assistant.navi.add_point	1
да хорошо	personal_assistant.scenarios.other	1
есть ли пробка	personal_assistant.navi.show_layer	1
сказал что а	personal_assistant.scenarios.other	1
поехали на знамя октября	personal_assistant.scenarios.show_route	1
кобозева 94 поехали	personal_assistant.scenarios.show_route	1
проложить маршрут улица шмидта 43	personal_assistant.scenarios.show_route	1
поехали халтуринский 98	personal_assistant.scenarios.show_route	1
показать быстрый маршрут	personal_assistant.navi.show_route_on_map	1
а я не знаю	personal_assistant.scenarios.other	1
как проехать на бобровского 5	personal_assistant.scenarios.show_route	1
впереди авария в левом ряду абельмановская улица дом 3	personal_assistant.navi.add_point	1
станица новотитаровская через витамин комбинат	personal_assistant.scenarios.show_route	1
да не хочу говорить отстань	personal_assistant.scenarios.other	1
едем до новый арбат	personal_assistant.scenarios.show_route	1
создать точку	personal_assistant.navi.add_point	1
где я сейчас покажи	personal_assistant.scenarios.get_my_location	1
привет яндекс работает	personal_assistant.scenarios.other	1
иди ты говорил	personal_assistant.scenarios.other	1
говорите готово что такое что я ничего не нажимал	personal_assistant.scenarios.other	1
найти местоположение мое	personal_assistant.scenarios.get_my_location	1
где я сейчас	personal_assistant.scenarios.get_my_location	1
поставили камера	personal_assistant.navi.add_point	1
сообщение	personal_assistant.navi.add_point	1
поехали 98	personal_assistant.scenarios.other	1
будайская улица дом 11 через мкад	personal_assistant.scenarios.show_route	1
кильдинская 21 поехали	personal_assistant.scenarios.show_route	1
проспект патриотов 57 а без пробок	personal_assistant.scenarios.show_route	1
чебоксары через трасса м 5	personal_assistant.scenarios.show_route	1
от гостиницы северный остановки до челюскинцев 44 / 1	personal_assistant.scenarios.show_route	1
пост дпс	personal_assistant.navi.add_point	1
трампарк где находится	personal_assistant.scenarios.find_poi	1
как проехать на театральную	personal_assistant.scenarios.show_route	1
поехали тульская 11	personal_assistant.scenarios.show_route	1
памуккале камера	personal_assistant.scenarios.other	1
сколько километров протяженность пробки	personal_assistant.navi.how_long_traffic_jam	1
холмогорова 83 проложить маршрут	personal_assistant.scenarios.show_route	1
ликино дулево поехали	personal_assistant.scenarios.show_route	1
яндекс поехали домой маловыгонная 5	personal_assistant.scenarios.show_route	1
где я нахожусь в городе волгограде	personal_assistant.scenarios.get_my_location	1
маршрут ленинградская 14	personal_assistant.scenarios.show_route	1
чери где я нахожусь	personal_assistant.scenarios.get_my_location	1
окей google покажи маршрут город армада	personal_assistant.scenarios.show_route	1
москва проезд березовой рощи 12 поехали	personal_assistant.scenarios.show_route	1
ангарская ангарная куда ведет	personal_assistant.scenarios.other	1
я тебе сказала когда это было	personal_assistant.scenarios.other	1
город москва подольских курсантов 17 а поехали	personal_assistant.scenarios.show_route	1
покажи где я стою	personal_assistant.scenarios.get_my_location	1
поехали федора полетаева 15	personal_assistant.scenarios.show_route	1
кукуй	personal_assistant.scenarios.find_poi	1
я знаю не скажу	personal_assistant.scenarios.other	1
слушай яндекс отмени пожалуйста	personal_assistant.scenarios.other	1
поехали спартаковская 6	personal_assistant.scenarios.show_route	1
пробки в люберцах	personal_assistant.scenarios.show_traffic	1
9 линия 78 поехали	personal_assistant.scenarios.show_route	1
что ты мы приехали	personal_assistant.scenarios.other	1
победы 18 смысле освобожусь магазины все закрыты	personal_assistant.scenarios.other	1
танкистов 18 а поехали	personal_assistant.scenarios.show_route	1
найди меня	personal_assistant.scenarios.get_my_location	1
аварии на дороге	personal_assistant.navi.add_point	1
поворот рождествено	personal_assistant.scenarios.find_poi	1
рядом с улица хлобыстова	personal_assistant.scenarios.other	1
построить маршрут зип больница	personal_assistant.scenarios.show_route	1
найди ближайший парковку	personal_assistant.navi.parking_route	1
более быстрый маршрут 5 корпус 1	personal_assistant.scenarios.other	1
ленинаван сервис где находится	personal_assistant.scenarios.find_poi	1
сейчас подожди я не могу	personal_assistant.scenarios.other	1
край сов пробок	personal_assistant.scenarios.other	1
проложить маршрут мкад	personal_assistant.scenarios.show_route	1
ну что не работает	personal_assistant.scenarios.other	1
да конечно	personal_assistant.scenarios.other	1
село ракитное белгородской области через богучар	personal_assistant.scenarios.show_route	1
вело моторы с	personal_assistant.scenarios.other	1
московский проспект 6 поехали	personal_assistant.scenarios.show_route	1
лечу декабристская	personal_assistant.scenarios.other	1
едем добросельская 176	personal_assistant.scenarios.show_route	1
поехали вавиловых 7 корпус 3	personal_assistant.scenarios.show_route	1
разговорчики почему стоит	personal_assistant.navi.add_point	1
я могу справятся	personal_assistant.scenarios.other	1
орион где находится	personal_assistant.scenarios.find_poi	1
фин место для парковки	personal_assistant.navi.parking_route	1
карта найди куда на море нам с водой	personal_assistant.scenarios.other	1
морской славы 1 поехали	personal_assistant.scenarios.show_route	1
поехали торговый центр круиз	personal_assistant.scenarios.show_route	1
проверить	personal_assistant.scenarios.other	1
проспект победы 78 поехали	personal_assistant.scenarios.show_route	1
бревново переехать	personal_assistant.scenarios.other	1
тайбокс	personal_assistant.scenarios.find_poi	1
поставить метку здесь красная	personal_assistant.navi.add_point	1
проложить маршрут шахты	personal_assistant.scenarios.show_route	1
как проехать горького 6	personal_assistant.scenarios.show_route	1
пожалуйста не работает	personal_assistant.scenarios.other	1
как доехать чимкент жд вокзал	personal_assistant.scenarios.show_route	1
хорошо ресторан пожалуйста где камера показывай	personal_assistant.scenarios.other	1
телеграф все работает 60 движения на московских дорога	personal_assistant.scenarios.other	1
правильно собино да	personal_assistant.scenarios.other	1
арцыбушевский переулок 6 маршрут	personal_assistant.scenarios.show_route	1
город гагарин показать пробки	personal_assistant.scenarios.show_traffic	1
покажи дорогу с	personal_assistant.scenarios.other	1
я могу сказать	personal_assistant.scenarios.other	1
а я не знаю куда позвонить	personal_assistant.scenarios.other	1
дорожные работы в левом ряду	personal_assistant.navi.add_point	1
проложить маршрут челюскинская дом 4	personal_assistant.scenarios.show_route	1
пробок загруженность	personal_assistant.scenarios.show_traffic	1
я не знаю не понимаю	personal_assistant.scenarios.other	1
придется от самары до николаевка	personal_assistant.scenarios.show_route	1
почему на карте не указан переулок где я нахожусь	personal_assistant.scenarios.other	1
где пробка	personal_assistant.navi.show_layer	1
не существующие	personal_assistant.scenarios.other	1
цветы мира где находится	personal_assistant.scenarios.find_poi	1
снт док цас	personal_assistant.scenarios.find_poi	1
что делать покажи покажи покажи	personal_assistant.scenarios.other	1
трасса м 4 до ростова пробки	personal_assistant.scenarios.show_route	1
и приходят проверяют	personal_assistant.scenarios.other	1
где находится камера под горой	personal_assistant.scenarios.other	1
давыдовская 5 поехали	personal_assistant.scenarios.show_route	1
поехали улица большая дорогомиловская дом 12	personal_assistant.scenarios.show_route	1
гора на поехать покажи дорогу	personal_assistant.scenarios.other	1
пенза через шемышейка	personal_assistant.scenarios.show_route	1
как отсюда до белоомута	personal_assistant.scenarios.show_route	1
краснознаменная 20 поехали	personal_assistant.scenarios.show_route	1
улица на которой я нахожусь	personal_assistant.scenarios.get_my_location	1
доехать до шереметьево	personal_assistant.scenarios.show_route	1
доехать улица елецкая 15	personal_assistant.scenarios.show_route	1
работа проложить маршрут	personal_assistant.scenarios.show_route	1
ремонт компьютеров по дороге домой	personal_assistant.scenarios.find_poi	1
правильно правильно	personal_assistant.scenarios.other	1
ага	personal_assistant.scenarios.other	1
5 баллов пробки в москве одинцово город	personal_assistant.scenarios.show_traffic	1
аструм	personal_assistant.scenarios.find_poi	1
тебе скажу	personal_assistant.scenarios.other	1
саввы белых 39 поехали	personal_assistant.scenarios.show_route	1
скажите где находится	personal_assistant.scenarios.other	1
сколько баллов пробки	personal_assistant.scenarios.show_traffic	1
только данк релита все я сейчас нахожусь я нахожусь	personal_assistant.scenarios.other	1
поворачивать	personal_assistant.scenarios.other	1
ну да да да да	personal_assistant.scenarios.other	1
поехали на пд г	personal_assistant.scenarios.show_route	1
да да да да да да	personal_assistant.scenarios.other	1
гагарина дом 71 поехали	personal_assistant.scenarios.show_route	1
закончил	personal_assistant.scenarios.other	1
кричу	personal_assistant.scenarios.other	1
куда поворачивать говори	personal_assistant.scenarios.sound_unmute	1
ближайший автомагазин авторусь	personal_assistant.scenarios.find_poi	1
маршака без пробок	personal_assistant.scenarios.show_route	1
пробки на трассе воронеж павловск	personal_assistant.scenarios.show_route	1
продолжается движения	personal_assistant.scenarios.other	1
короткий путь без пробки до барвиха	personal_assistant.scenarios.show_route	1
поехали адмирала макарова 23 корпус 2	personal_assistant.scenarios.show_route	1
не хочет меня бесплатная парковка	personal_assistant.scenarios.other	1
сам бери мой	personal_assistant.scenarios.other	1
продают	personal_assistant.scenarios.other	1
поехали ленина 395	personal_assistant.scenarios.show_route	1
поехали проспект победы 69	personal_assistant.scenarios.show_route	1
7 пробок	personal_assistant.scenarios.show_traffic	1
построить маршрут рязань улица	personal_assistant.scenarios.show_route	1
удалить маршрут	personal_assistant.navi.reset_route	1
жк учи	personal_assistant.scenarios.find_poi	1
поехал туда	personal_assistant.scenarios.other	1
если на своей машине кататься	personal_assistant.scenarios.other	1
заведенная красный белый по дороге	personal_assistant.scenarios.other	1
город домодедово улица логистическая 1 корпус 17 объехать пробки	personal_assistant.scenarios.show_route	1
доехать до солидарности 95 а	personal_assistant.scenarios.show_route	1
разгуляй	personal_assistant.scenarios.find_poi	1
я знаю я знаю	personal_assistant.scenarios.other	1
ну да старково	personal_assistant.scenarios.other	1
а что что говорить	personal_assistant.scenarios.other	1
поехали бусиновская горка дом 2	personal_assistant.scenarios.show_route	1
когда закончится пробка	personal_assistant.navi.how_long_traffic_jam	1
молодой гвардии 1 поехали	personal_assistant.scenarios.show_route	1
днем волоколамским дтп	personal_assistant.navi.add_point	1
грузовые закрытые парковки	personal_assistant.scenarios.find_poi	1
обзор парк офис	personal_assistant.scenarios.other	1
ну он показывает	personal_assistant.scenarios.other	1
ростов на дону через орловка	personal_assistant.scenarios.show_route	1
зеленоград корпус 803 поехали	personal_assistant.scenarios.show_route	1
парковки рц перекресток	personal_assistant.scenarios.find_poi	1
улица пробок	personal_assistant.scenarios.find_poi	1
через город пулково 1	personal_assistant.scenarios.show_route	1
я думаю что завтра	personal_assistant.scenarios.other	1
держава камера	personal_assistant.scenarios.other	1
местоположение маркера	personal_assistant.scenarios.get_my_location	1
поехали войнова 17	personal_assistant.scenarios.show_route	1
грейс о есть	personal_assistant.scenarios.other	1
бетономешалка здорово я	personal_assistant.scenarios.other	1
шевали	personal_assistant.scenarios.find_poi	1
гагарина отделение полиции	personal_assistant.scenarios.find_poi	1
дефановка парковки	personal_assistant.scenarios.find_poi	1
карповича дом 10 пробки	personal_assistant.scenarios.show_route	1
поехали улица иовлева дом 3	personal_assistant.scenarios.show_route	1
ближайшая заправка казмунайгаз	personal_assistant.scenarios.find_poi	1
улица нахожусь я	personal_assistant.scenarios.get_my_location	1
луга	personal_assistant.scenarios.find_poi	1
большевиков 11 корпус 2 поехали	personal_assistant.scenarios.show_route	1
напиши добродел	personal_assistant.scenarios.other	1
говорите сказал что тебе нужно	personal_assistant.scenarios.other	1
показать пробки на 2 брянске	personal_assistant.scenarios.show_traffic	1
что сделать	personal_assistant.scenarios.other	1
во 2 послушай я тебя не работает не понимаешь	personal_assistant.scenarios.other	1
тебе говорю тебе сказал	personal_assistant.scenarios.other	1
предложите	personal_assistant.scenarios.other	1
улица димитрова дом 18 корпус 2 поехали	personal_assistant.scenarios.show_route	1
так ехали	personal_assistant.scenarios.other	1
без пробок	personal_assistant.navi.hide_layer	1
ехать улица долгоруковская дом 34	personal_assistant.scenarios.show_route	1
окей google 4 где находится	personal_assistant.scenarios.other	1
ленинский проспект 82 поехали	personal_assistant.scenarios.show_route	1
проспект вернадского 37 корпус 1 а москва поехали	personal_assistant.scenarios.show_route	1
как проехать поселок куеда	personal_assistant.scenarios.show_route	1
объезд пробок на дороге	personal_assistant.navi.show_route_on_map	1
соединение со спутниками восстановлена	personal_assistant.scenarios.other	1
остановить маршрут	personal_assistant.navi.reset_route	1
посмотри что говорить говорите	personal_assistant.scenarios.other	1
сколько еще по времени будут пробки	personal_assistant.navi.how_long_traffic_jam	1
красина 23 с этой больше нет нет вот так поняла	personal_assistant.scenarios.other	1
тюмень как доехать	personal_assistant.scenarios.show_route	1
посмотреть левый правый ряд	personal_assistant.scenarios.other	1
едем батайск днт труд	personal_assistant.scenarios.show_route	1
поехали проспект победы 122	personal_assistant.scenarios.show_route	1
я не знаю что делать поедем	personal_assistant.scenarios.other	1
блэк стар бургер поехали	personal_assistant.scenarios.show_route	1
о сейчас вод	personal_assistant.scenarios.other	1
не вижу	personal_assistant.scenarios.other	1
поехали на уральскую 70	personal_assistant.scenarios.show_route	1
поставы поехали	personal_assistant.scenarios.show_route	1
салмычи мира 2 б	personal_assistant.scenarios.find_poi	1
а где мы находимся	personal_assistant.scenarios.get_my_location	1
что я не понял 10	personal_assistant.scenarios.other	1
удалить старая маршрута	personal_assistant.navi.reset_route	1
заневский проспект построить маршрут	personal_assistant.scenarios.show_route	1
кулгали	personal_assistant.scenarios.find_poi	1
поехали живописная 28	personal_assistant.scenarios.show_route	1
пробки в саратове	personal_assistant.scenarios.show_traffic	1
ты мне покажи где камеры стоял	personal_assistant.navi.show_layer	1
дорожные работы фомичевой	personal_assistant.navi.add_point	1
запрещенная	personal_assistant.scenarios.other	1
поехали улица горького	personal_assistant.scenarios.show_route	1
должно быть вот спортмастер	personal_assistant.scenarios.other	1
что я не понял	personal_assistant.scenarios.other	1
чемоданчик дружить только так	personal_assistant.scenarios.other	1
пошла	personal_assistant.scenarios.other	1
окей google где нахожусь	personal_assistant.scenarios.get_my_location	1
поехали улица дивенская 4	personal_assistant.scenarios.show_route	1
ну что ты смотрим баллов пробки	personal_assistant.scenarios.show_traffic	1
да	personal_assistant.scenarios.other	1
ешь пей	personal_assistant.scenarios.find_poi	1
едем балашиха улица ленина дом 3	personal_assistant.scenarios.show_route	1
город краснодар улица атарбекова 15 поехать	personal_assistant.scenarios.show_route	1
ульяновская 32 через ульяновская 14	personal_assistant.scenarios.show_route	1
осторожно	personal_assistant.scenarios.other	1
поедем сбербанк поехали	personal_assistant.scenarios.show_route	1
яндекс сколько это что там пробка	personal_assistant.navi.how_long_traffic_jam	1
я хочу чтобы они	personal_assistant.scenarios.other	1
местоположение неправильно	personal_assistant.scenarios.other	1
ты не знаю	personal_assistant.scenarios.other	1
ближайшее отделение альфа банка	personal_assistant.scenarios.find_poi	1
петровка поехали	personal_assistant.scenarios.show_route	1
строй на льва толстого 2 а	personal_assistant.scenarios.show_route	1
покажи маршрут на добрыниха	personal_assistant.scenarios.show_route	1
вообще михальцево можно 20 дробь пробки где пробки	personal_assistant.scenarios.other	1
яндекс найди мне грузовую парковку где можно припарковаться	personal_assistant.scenarios.find_poi	1
включи режим парковки	personal_assistant.navi.show_layer	1
едем отрадная 46	personal_assistant.scenarios.show_route	1
я где сейчас нахожусь	personal_assistant.scenarios.get_my_location	1
где я сейчас нахожусь в каком доме	personal_assistant.scenarios.get_my_location	1
поехали айдарова 5	personal_assistant.scenarios.show_route	1
я могу нажимай 9	personal_assistant.scenarios.other	1
комаровского 5 поехали	personal_assistant.scenarios.show_route	1
де побудовано	personal_assistant.scenarios.other	1
смотреть бесплатно остановка	personal_assistant.navi.show_layer	1
показать камеры	personal_assistant.navi.show_layer	1
далеко идти	personal_assistant.scenarios.other	1
северный бульвар дом 7 без пробок	personal_assistant.scenarios.show_route	1
ты куда сейчас доедем а потом направо	personal_assistant.scenarios.other	1
пробки по калужский переулок 10	personal_assistant.scenarios.show_route	1
не совсем обычный двухсторонний	personal_assistant.scenarios.other	1
улица фучика 2 поехали	personal_assistant.scenarios.show_route	1
яндекс слушай найди меня	personal_assistant.scenarios.get_my_location	1
пробки метро тульская	personal_assistant.scenarios.show_traffic	1
алиса где я нахожусь	personal_assistant.scenarios.get_my_location	1
солнцевский проспект 2	personal_assistant.scenarios.find_poi	1
витебский рядом	personal_assistant.scenarios.find_poi	1
поехали едем	personal_assistant.scenarios.show_route	1
город москва улица марксистская дом 3 строение 2 поехали	personal_assistant.scenarios.show_route	1
худат едем на дону	personal_assistant.scenarios.other	1
шпалерная 60 поехали	personal_assistant.scenarios.show_route	1
главный вход работы на ряд	personal_assistant.scenarios.other	1
где я сейчас нахожусь и что за улица	personal_assistant.scenarios.get_my_location	1
скрытая камера дпс	personal_assistant.navi.add_point	1
слушай яндекс поехали в коблево	personal_assistant.scenarios.show_route	1
маршрут до авроры	personal_assistant.scenarios.show_route	1
проложить маршрут открытое шоссе 24 корпус 12	personal_assistant.scenarios.show_route	1
поехали улица красноармейская 97	personal_assistant.scenarios.show_route	1
ласкала	personal_assistant.scenarios.other	1
едем до вахтангова 5 а	personal_assistant.scenarios.show_route	1
покажи мне пробки	personal_assistant.navi.show_layer	1
это знаешь	personal_assistant.scenarios.other	1
показать подробнее маршрут	personal_assistant.navi.show_route_on_map	1
пробки в районе лосево	personal_assistant.scenarios.show_traffic	1
балаган жене куда от красного до фиолетова глаза чурины роджер стальную пробочка кожиной вестэнд бьет с толстой жилка он был в натуральных тихая	personal_assistant.scenarios.other	1
что говорить и куда говорите	personal_assistant.scenarios.other	1
точный адрес я сейчас нахожусь	personal_assistant.scenarios.get_my_location	1
новорязанское шоссе	personal_assistant.scenarios.find_poi	1
крикковское шоссе 2 б поехали	personal_assistant.scenarios.show_route	1
мочить	personal_assistant.scenarios.other	1
вышел	personal_assistant.scenarios.other	1
сейчас я где стою	personal_assistant.scenarios.get_my_location	1
бирюлевская 13 корпус 3 поехали	personal_assistant.scenarios.show_route	1
google поставь разговорчики	personal_assistant.navi.add_point	1
большие каменщики дом 15 поехали	personal_assistant.scenarios.show_route	1
добавить сообщение	personal_assistant.navi.add_point	1
может быть что	personal_assistant.scenarios.other	1
построй островитянова 5	personal_assistant.scenarios.show_route	1
где я сейчас данный момент нахожусь	personal_assistant.scenarios.get_my_location	1
декабристов 116 поехали	personal_assistant.scenarios.show_route	1
так дорогу	personal_assistant.scenarios.other	1
что ты перепутал	personal_assistant.scenarios.other	1
кашкай	personal_assistant.scenarios.other	1
поворот направо затем проспект 11	personal_assistant.scenarios.other	1
ленинградская 78 поехали	personal_assistant.scenarios.show_route	1
нотариальный меня уже	personal_assistant.scenarios.other	1
заревый проезд 6 поехали	personal_assistant.scenarios.show_route	1
показать дорогу кочубей	personal_assistant.scenarios.show_route	1
поехали бульвар яна райниса 37 корпус 1	personal_assistant.scenarios.show_route	1
да да да да справа это получается ресторан тарас	personal_assistant.scenarios.other	1
не надо мне пожалуйста	personal_assistant.scenarios.other	1
когда приедешь	personal_assistant.navi.when_we_get_there	1
1 квартал мехзавода дом 31 поехали	personal_assistant.scenarios.show_route	1
скажи	personal_assistant.scenarios.other	1
сколько баллов пробки в ижевске	personal_assistant.scenarios.show_traffic	1
баллов пробки на потом до инженерная 5	personal_assistant.scenarios.other	1
яндекс подскажи пожалуйста где мое местоположение	personal_assistant.scenarios.get_my_location	1
поедем киноклуб эльдар	personal_assistant.scenarios.show_route	1
томилино завод железобетонный комбинат где находится	personal_assistant.scenarios.find_poi	1
поворот на станица запорожская	personal_assistant.scenarios.find_poi	1
едем на азс лукойл	personal_assistant.scenarios.show_route	1
ты что говорить	personal_assistant.scenarios.other	1
дряблово поворот дача	personal_assistant.scenarios.find_poi	1
камеры стоят	personal_assistant.navi.add_point	1
центр сормова поехали	personal_assistant.scenarios.show_route	1
сейчас где пробки с	personal_assistant.scenarios.show_traffic	1
по какому адресу я нахожусь	personal_assistant.scenarios.get_my_location	1
где мы сейчас находимся окей google	personal_assistant.scenarios.get_my_location	1
проложить маршрут комсомольская 53	personal_assistant.scenarios.show_route	1
говорите и заказ	personal_assistant.scenarios.other	1
сейчас подъеду	personal_assistant.scenarios.other	1
какие пробки	personal_assistant.scenarios.show_traffic	1
отменить	personal_assistant.scenarios.other	1
профсоюзная 45 корпус 1 поехали	personal_assistant.scenarios.show_route	1
сейчас скажу где находится	personal_assistant.scenarios.get_my_location	1
антоненко 6 без пробок	personal_assistant.scenarios.show_route	1
показать маршрут новохоперск	personal_assistant.scenarios.show_route	1
ближайший альфа банк отделение	personal_assistant.scenarios.find_poi	1
въезд сюда	personal_assistant.scenarios.other	1
поехали набережный проезд 12	personal_assistant.scenarios.show_route	1
адрес где я	personal_assistant.scenarios.get_my_location	1
через 202	personal_assistant.scenarios.other	1
покажи пожалуйста маршрут	personal_assistant.navi.show_route_on_map	1
ямонтово проложить маршрут	personal_assistant.scenarios.show_route	1
покажи пробки на пути	personal_assistant.navi.show_layer	1
митрофанова 11 а поехали	personal_assistant.scenarios.show_route	1
да	personal_assistant.scenarios.other	1
я понимаю как хочется	personal_assistant.scenarios.other	1
шверника 11 корпус 3 подъезд 2 проложить маршрут	personal_assistant.scenarios.show_route	1
лежена 27 / 1	personal_assistant.scenarios.find_poi	1
окей google я сейчас где	personal_assistant.scenarios.get_my_location	1
яндекс слушай поехали восстания 75	personal_assistant.scenarios.show_route	1
говорите написано	personal_assistant.scenarios.other	1
пробка в пути	personal_assistant.navi.show_route_on_map	1
улица где я	personal_assistant.scenarios.get_my_location	1
куда надо знаете	personal_assistant.scenarios.other	1
об дпс ювао	personal_assistant.scenarios.find_poi	1
где я где	personal_assistant.scenarios.get_my_location	1
подожди	personal_assistant.scenarios.other	1
только в пасху стоят милиционеры корректирующий	personal_assistant.scenarios.other	1
тихвинская 8 поехали	personal_assistant.scenarios.show_route	1
поехали рублевское шоссе 42 корпус 2	personal_assistant.scenarios.show_route	1
показать пробки на салавата юлаева	personal_assistant.scenarios.show_traffic	1
давай напишем комментарий	personal_assistant.navi.add_point	1
поехали воронова 12 к	personal_assistant.scenarios.show_route	1
ну все да	personal_assistant.scenarios.other	1
ростов на дону без пробок самая короткая дорога	personal_assistant.scenarios.show_route	1
савеловский вокзал поехали бутырская дом	personal_assistant.scenarios.show_route	1
фотографировать	personal_assistant.scenarios.other	1
скажите и восколько подъехать и чтобы ему	personal_assistant.scenarios.other	1
что там с пробками	personal_assistant.scenarios.show_traffic	1
да да да все правильно	personal_assistant.scenarios.other	1
винницкая 4 а поехали	personal_assistant.scenarios.show_route	1
поехали 6 радиальная дом 5 корпус 3	personal_assistant.scenarios.show_route	1
контроль скорости камера	personal_assistant.navi.add_point	1
грибоедова 7 поехали	personal_assistant.scenarios.show_route	1
протяженность пробки	personal_assistant.navi.how_long_traffic_jam	1
яндекс поехали улица коцаря дом 3	personal_assistant.scenarios.show_route	1
пост дпс пулково	personal_assistant.scenarios.find_poi	1
показать пробки в цивильске мост	personal_assistant.scenarios.show_traffic	1
проспект народного проспект народного ополчения 201 поехали	personal_assistant.scenarios.show_route	1
магазин российских автозапчастей ближайший	personal_assistant.scenarios.find_poi	1
что говорит говорите	personal_assistant.scenarios.other	1
экшен 24 камера	personal_assistant.scenarios.other	1
я вызываю парковку	personal_assistant.navi.show_layer	1
карпинского 12 поехали	personal_assistant.scenarios.show_route	1
полюс холода	personal_assistant.scenarios.other	1
построить маршрут проспект дзержинского 77 ярославль	personal_assistant.scenarios.show_route	1
построй маршрут метро петровско разумовская	personal_assistant.scenarios.show_route	1
где я нахожусь местоположение мое	personal_assistant.scenarios.get_my_location	1
метро где камеры	personal_assistant.scenarios.other	1
авторусь на люблинке	personal_assistant.scenarios.find_poi	1
где мое устройства где я нахожусь	personal_assistant.scenarios.get_my_location	1
к маме поехали	personal_assistant.scenarios.show_route	1
парковка рядом	personal_assistant.navi.parking_route	1
поворот на час	personal_assistant.scenarios.other	1
павла шаманова 6 поехали	personal_assistant.scenarios.show_route	1
правая полоса дтп	personal_assistant.navi.add_point	1
нахожусь я	personal_assistant.scenarios.get_my_location	1
мое местоположение в волгограде	personal_assistant.scenarios.get_my_location	1
10 км от мкада по калужскому саша	personal_assistant.scenarios.find_poi	1
узнать мое местонахождение человека по номеру телефона	personal_assistant.scenarios.other	1
железнодорожный проспект дом 11 поехали	personal_assistant.scenarios.show_route	1
сек оформлять там	personal_assistant.scenarios.other	1
я понял что хочешь	personal_assistant.scenarios.other	1
где сейчас пробки	personal_assistant.scenarios.show_traffic	1
как проехать в кисловодск	personal_assistant.scenarios.show_route	1
даниловская набережная 6 корпус 3 поехали	personal_assistant.scenarios.show_route	1
как доехать до ногинска	personal_assistant.scenarios.show_route	1
перечислить	personal_assistant.scenarios.other	1
кафе рядом кафе	personal_assistant.scenarios.find_poi	1
магазин вкусвилл ближайшее метро щукино	personal_assistant.scenarios.find_poi	1
где нет пробок	personal_assistant.scenarios.other	1
поехали свердлова 31	personal_assistant.scenarios.show_route	1
ростов через щепкино	personal_assistant.scenarios.show_route	1
покажи дорогу домой	personal_assistant.scenarios.show_route	1000
дружбы 62 новокузнецк маршрут	personal_assistant.scenarios.show_route	1
бесплатные парковки	personal_assistant.navi.show_layer	1
поехали бартеневская 41 корпус 1	personal_assistant.scenarios.show_route	1
отобрази пробки	personal_assistant.navi.show_layer	1
установить точку авария в правом берегу	personal_assistant.navi.add_point	1
не могу сказать какой 1	personal_assistant.scenarios.other	1
поехали гаражная 80	personal_assistant.scenarios.show_route	1
энгельса где я нахожусь в данный момент	personal_assistant.scenarios.other	1
буду поддоны со стороны	personal_assistant.scenarios.other	1
например здесь блока 74	personal_assistant.scenarios.other	1
ближайшая мойка для грузовых автомобилей	personal_assistant.scenarios.find_poi	1
нет не хочу	personal_assistant.scenarios.other	1
ленинский проспект 79 корпус 2 поехали	personal_assistant.scenarios.show_route	1
набери	personal_assistant.scenarios.other	1
отправить сообщение	personal_assistant.navi.add_point	1
гостиничный проезд 4 б как проехать	personal_assistant.scenarios.show_route	1
степной поехали	personal_assistant.scenarios.show_route	1
написать сообщение	personal_assistant.navi.add_point	1
показать пробки ростова	personal_assistant.scenarios.show_traffic	1
поехали бориса домашникова 22	personal_assistant.scenarios.show_route	1
ну ладно тогда поедем в детский сад	personal_assistant.scenarios.show_route	1
мое солнышко	personal_assistant.scenarios.other	1
зета получается все коврижки	personal_assistant.scenarios.other	1
сейчас поворачивать	personal_assistant.scenarios.other	1
остановить маршрут	personal_assistant.navi.reset_route	1
показать мое местонахождение	personal_assistant.scenarios.get_my_location	1
город донецк через новоазовск	personal_assistant.scenarios.show_route	1
бетонка 43 километр пробки	personal_assistant.scenarios.show_traffic	1
теле 2 магазины поблизости	personal_assistant.scenarios.find_poi	1
покажите и где я живу	personal_assistant.scenarios.find_poi	1
сулпак где находится	personal_assistant.scenarios.find_poi	1
поехали партизана железняка 3	personal_assistant.scenarios.show_route	1
дтп в правом ряду	personal_assistant.navi.add_point	1
да есть	personal_assistant.scenarios.other	1
забыл	personal_assistant.scenarios.other	1
панкот поехали	personal_assistant.scenarios.show_route	1
мира 102 поехали	personal_assistant.scenarios.show_route	1
маршрут константина паустовского 8	personal_assistant.scenarios.show_route	1
ближайшее гибдд около метро домодедовская	personal_assistant.scenarios.find_poi	1
остановка по требованию	personal_assistant.scenarios.other	1
марата 33 а поехали	personal_assistant.scenarios.show_route	1
стачки 215 поехали	personal_assistant.scenarios.show_route	1
улица кушает пелевская дорога	personal_assistant.scenarios.other	1
реутов улица новая дом 3 поехали	personal_assistant.scenarios.show_route	1
алена где я живу	personal_assistant.scenarios.find_poi	1
вернуться на мое местоположение	personal_assistant.scenarios.get_my_location	1
я это я знаю что на юге	personal_assistant.scenarios.other	1
поехали на 9 мая 77	personal_assistant.scenarios.show_route	1
поехали мичурина 7	personal_assistant.scenarios.show_route	1
местоположение маркер а	personal_assistant.scenarios.get_my_location	1
едем пулковское шоссе 26 корпус 7	personal_assistant.scenarios.show_route	1
маршрут нужен бесплатный	personal_assistant.navi.show_route_on_map	1
здесь и показать сказать а	personal_assistant.scenarios.other	1
пятерочка 24 часа ближайшее	personal_assistant.scenarios.find_poi	1
шмидта 3 через площадь ленина	personal_assistant.scenarios.show_route	1
прямо да	personal_assistant.scenarios.other	1
сколько стоит парковки	personal_assistant.navi.show_layer	1
домой через ильинское	personal_assistant.scenarios.show_route	1
едем улица ухтомская	personal_assistant.scenarios.show_route	1
до нижнего	personal_assistant.scenarios.show_route	1
11 спецполк дпс	personal_assistant.scenarios.find_poi	1
поехали до кальян	personal_assistant.scenarios.show_route	1
остановка где я сижу	personal_assistant.scenarios.get_my_location	1
что говорите говорить и	personal_assistant.scenarios.other	1
место дтп	personal_assistant.navi.add_point	1
как проехать на улицу карцева дом 5	personal_assistant.scenarios.show_route	1
проспект союзный 5 на пробок	personal_assistant.scenarios.show_route	1
говорите алло	personal_assistant.scenarios.other	1
улица гурзуфская 12 проложить маршрут	personal_assistant.scenarios.show_route	1
удалить все адреса	personal_assistant.scenarios.other	1
пробки включить готово	personal_assistant.navi.show_layer	1
россия как известно проблемы	personal_assistant.scenarios.other	1
показывать все камеры	personal_assistant.navi.show_layer	1
на дороге челябинск которые есть поближе заправка газовая сколько километр отсюда	personal_assistant.scenarios.other	1
аренда где я нахожусь	personal_assistant.scenarios.other	1
ты ты дорогу значит тогда показывай	personal_assistant.scenarios.other	1
люди приходит 2 я говорю говорю	personal_assistant.scenarios.other	1
поехали на кояновская 6	personal_assistant.scenarios.show_route	1
зара торт поехали	personal_assistant.scenarios.show_route	1
кажется да	personal_assistant.scenarios.other	1
ближайшее кафе бизнес ланч	personal_assistant.scenarios.find_poi	1
говорите говорит говорите говорю	personal_assistant.scenarios.other	1
указать маршрут махачкала ереван	personal_assistant.scenarios.show_route	1
что хочешь	personal_assistant.scenarios.other	1
лежена 27 / 1	personal_assistant.scenarios.find_poi	1
поехали липовцы улица приозерная 13	personal_assistant.scenarios.show_route	1
ай пройти	personal_assistant.scenarios.other	1
поселок мис построить маршрут	personal_assistant.scenarios.show_route	1
камера на коласа	personal_assistant.navi.add_point	1
не надо	personal_assistant.scenarios.other	1
улица дудинка поехали	personal_assistant.scenarios.show_route	1
пробки на дорогах есть	personal_assistant.navi.show_layer	1
маршала еременко 68 показать маршрут	personal_assistant.scenarios.show_route	1
дом едет	personal_assistant.scenarios.show_route	1
пруды местоположение телефона	personal_assistant.scenarios.other	1
поехали 43 линия 22	personal_assistant.scenarios.show_route	1
построить маршрут до ближайшего магазина	personal_assistant.scenarios.show_route	1
дтп средний	personal_assistant.navi.add_point	1
каждый вторник тк пробка	personal_assistant.scenarios.other	1
камеры контроля полосы	personal_assistant.navi.add_point	1
дубининская 20 корпус 1 поехали	personal_assistant.scenarios.show_route	1
как проехать приморская 21	personal_assistant.scenarios.show_route	1
поехали до аджигардак	personal_assistant.scenarios.show_route	1
рождественка 19 поехали	personal_assistant.scenarios.show_route	1
подожди тихо	personal_assistant.scenarios.other	1
начинаем скач парковку	personal_assistant.scenarios.other	1
проложить маршрут от каширское шоссе 61 до москва сити	personal_assistant.scenarios.show_route	1
продаются свои	personal_assistant.scenarios.other	1
поехали мамина сибиряка 52	personal_assistant.scenarios.show_route	1
мвд шафиева	personal_assistant.scenarios.find_poi	1
гражданки серново тут	personal_assistant.scenarios.other	1
окей google где я нахожусь	personal_assistant.scenarios.get_my_location	1
улица писать хочу пробок	personal_assistant.scenarios.other	1
не надо мне	personal_assistant.scenarios.other	1
где мое местоположение е	personal_assistant.scenarios.get_my_location	1
пушкарев без пробок	personal_assistant.scenarios.show_route	1
установить разговор	personal_assistant.navi.add_point	1
снимать	personal_assistant.scenarios.other	1
мое местоположение тупой существа	personal_assistant.scenarios.get_my_location	1
рязанки сколько стоит	personal_assistant.scenarios.show_traffic	1
показать пробку	personal_assistant.navi.show_layer	1
генерала белова 59 поехали	personal_assistant.scenarios.show_route	1
сейчас попробую	personal_assistant.scenarios.other	1
ип прежде всего	personal_assistant.scenarios.other	1
вижу дтп правая полоса	personal_assistant.navi.add_point	1
комсомольский проспект дом 5 поехали	personal_assistant.scenarios.show_route	1
где можно паркуются	personal_assistant.navi.show_layer	1
седина 164 7 баллов пробки	personal_assistant.scenarios.other	1
говорить что говорить	personal_assistant.scenarios.other	1
глазкова 8 а поехали	personal_assistant.scenarios.show_route	1
поехали песьянка	personal_assistant.scenarios.show_route	1
где карта я ищу	personal_assistant.scenarios.other	1
аэропорт пулково показать без пробок	personal_assistant.scenarios.show_route	1
да надо	personal_assistant.scenarios.other	1
договорились	personal_assistant.scenarios.other	1
где я сейчас нахожусь на какой улице	personal_assistant.scenarios.get_my_location	1
лобненская дом 20 поехали	personal_assistant.scenarios.show_route	1
есть есть да	personal_assistant.scenarios.other	1
слушай яндекс отменить построить маршрут	personal_assistant.navi.reset_route	1
проложить дорогу марчуки 2	personal_assistant.scenarios.show_route	1
снимать покупать квартира	personal_assistant.scenarios.other	1
сейчас я где нахажу	personal_assistant.scenarios.get_my_location	1
героя россии 2 маршрут	personal_assistant.scenarios.show_route	1
все что они говорят	personal_assistant.scenarios.other	1
обнови положил	personal_assistant.scenarios.other	1
поехали щербинка улица брусилова 41	personal_assistant.scenarios.show_route	1
говори куда какой адрес	personal_assistant.scenarios.other	1
морозовская дом 8 поехали	personal_assistant.scenarios.show_route	1
бути рощи а почему ты не верить выдай роща выборг	personal_assistant.scenarios.other	1
слушай яндекс где мы находимся	personal_assistant.scenarios.get_my_location	1
улица геологов 72 поехали	personal_assistant.scenarios.show_route	1
проложи маршрут город краснодар улица кубано набережная 85	personal_assistant.scenarios.show_route	1
еркосай	personal_assistant.scenarios.find_poi	1
поехали старобельская улица	personal_assistant.scenarios.show_route	1
поедем светлогорская 17 а	personal_assistant.scenarios.show_route	1
куда сейчас направо и налево	personal_assistant.scenarios.other	1
остинская 36 поехали	personal_assistant.scenarios.show_route	1
да да прямо	personal_assistant.scenarios.other	1
покажи маршрут прилесье	personal_assistant.scenarios.show_route	1
улица георгия димитрова 1 а построить маршрут	personal_assistant.scenarios.show_route	1
атлантик ст поехали	personal_assistant.scenarios.show_route	1
пробки на дорогах	personal_assistant.scenarios.show_traffic	1
ничего не работает	personal_assistant.scenarios.other	1
покажи дорогу без пробок до москвы от обнинска до москвы	personal_assistant.scenarios.show_route	1
не скучно	personal_assistant.scenarios.other	1
убери парковку	personal_assistant.navi.hide_layer	1
московская 77 поехали	personal_assistant.scenarios.show_route	1
что тебе сказать не говорит что я ему сказала	personal_assistant.scenarios.other	1
там за ошибка	personal_assistant.scenarios.other	1
гузель	personal_assistant.scenarios.find_poi	1
показать дорогу таксистов пожалуйста	personal_assistant.navi.show_route_on_map	1
пробки тугургой	personal_assistant.scenarios.show_traffic	1
на проспект победы без пробок	personal_assistant.scenarios.show_route	1
построить маршрут артиллерийская улица гостиница русь	personal_assistant.scenarios.show_route	1
куда мой отец пошел	personal_assistant.scenarios.other	1
юкки север где находится	personal_assistant.scenarios.find_poi	1
парковка у трц сипайлово	personal_assistant.scenarios.find_poi	1
куда мы пошел	personal_assistant.scenarios.other	1
кирова 51 проложить маршрут	personal_assistant.scenarios.show_route	1
говори куда	personal_assistant.scenarios.other	1
парикмахерская ближайшая	personal_assistant.scenarios.find_poi	1
мое местонахождение гражданский 88 корпус 6	personal_assistant.scenarios.other	1
я хочу я хочу найти мою подругу вику хорошо	personal_assistant.scenarios.other	1
рядом большой козихинский переулок дом 27	personal_assistant.scenarios.find_poi	1
смотреть фильмы да	personal_assistant.scenarios.other	1
и на развязке дальше пробки	personal_assistant.scenarios.other	1
едем совхозная 9 а	personal_assistant.scenarios.show_route	1
нищенка ходишь да	personal_assistant.scenarios.other	1
бьянки 3 через мкад	personal_assistant.scenarios.show_route	1
впереди дорожные работы	personal_assistant.navi.add_point	1
ближайшая пекарня жар свежар	personal_assistant.scenarios.find_poi	1
сев	personal_assistant.scenarios.other	1
где я нахожусь siri	personal_assistant.scenarios.get_my_location	1
улица зорге проложить маршрут	personal_assistant.scenarios.show_route	1
парковки такси	personal_assistant.scenarios.find_poi	1
проспект кима дом 4 поехали	personal_assistant.scenarios.show_route	1
как проехать до китайского рынка	personal_assistant.scenarios.show_route	1
город батайск улица комсомольская 115 поехали	personal_assistant.scenarios.show_route	1
как доехать до минская 1 г	personal_assistant.scenarios.show_route	1
показать на карте этот маршрут	personal_assistant.navi.show_route_on_map	1
поехать рязанский проспект 14	personal_assistant.scenarios.show_route	1
покажи пробки на волоколамке	personal_assistant.scenarios.show_traffic	1
без пробок загородное шоссе дом 8	personal_assistant.scenarios.show_route	1
смотри он едет до тебя	personal_assistant.scenarios.other	1
поставь разговорчики почему стоит	personal_assistant.navi.add_point	1
поехали на улицу казанская дом 7	personal_assistant.scenarios.show_route	1
отдел гаи гибдд	personal_assistant.scenarios.find_poi	1
уменьшить	personal_assistant.scenarios.other	1
дом 42 поехали	personal_assistant.scenarios.show_route	1
ближайшая скупка часов	personal_assistant.scenarios.find_poi	1
поехали шейнкмана 123	personal_assistant.scenarios.show_route	1
москва	personal_assistant.scenarios.find_poi	1
аэропорт шереметьево	personal_assistant.scenarios.find_poi	1
сбербанк	personal_assistant.scenarios.find_poi	1
казанский вокзал	personal_assistant.scenarios.find_poi	1
московский вокзал	personal_assistant.scenarios.find_poi	1
ленинградский вокзал	personal_assistant.scenarios.find_poi	1
город кемерово	personal_assistant.scenarios.find_poi	1
мытищи	personal_assistant.scenarios.find_poi	1
химки	personal_assistant.scenarios.find_poi	1
леруа мерлен	personal_assistant.scenarios.find_poi	1
макдоналдс	personal_assistant.scenarios.find_poi	1
белорусский вокзал	personal_assistant.scenarios.find_poi	1
метро кузьминки	personal_assistant.scenarios.find_poi	1
газпромнефть	personal_assistant.scenarios.find_poi	1
заправка	personal_assistant.scenarios.find_poi	1
метро щелковская	personal_assistant.scenarios.find_poi	1
метро юго западная	personal_assistant.scenarios.find_poi	1
балашиха	personal_assistant.scenarios.find_poi	1
лукойл	personal_assistant.scenarios.find_poi	1
азс лукойл	personal_assistant.scenarios.find_poi	1
азс газпромнефть	personal_assistant.scenarios.find_poi	1
макдональдс	personal_assistant.scenarios.find_poi	1
метро марьино	personal_assistant.scenarios.find_poi	1
новый арбат	personal_assistant.scenarios.find_poi	1
зеленоград	personal_assistant.scenarios.find_poi	1
метро котельники	personal_assistant.scenarios.find_poi	1
пятерочка	personal_assistant.scenarios.find_poi	1
санкт петербург	personal_assistant.scenarios.find_poi	1
мойка самообслуживания	personal_assistant.scenarios.find_poi	1
метро пражская	personal_assistant.scenarios.find_poi	1
москва сити	personal_assistant.scenarios.find_poi	1
долгопрудный	personal_assistant.scenarios.find_poi	1
нижний новгород	personal_assistant.scenarios.find_poi	1
ярославский вокзал	personal_assistant.scenarios.find_poi	1
шереметьево	personal_assistant.scenarios.find_poi	1
метро вднх	personal_assistant.scenarios.find_poi	1
шаурма	personal_assistant.scenarios.find_poi	1
метро алтуфьево	personal_assistant.scenarios.find_poi	1
метро войковская	personal_assistant.scenarios.find_poi	1
рынок садовод	personal_assistant.scenarios.find_poi	1
метро речной вокзал	personal_assistant.scenarios.find_poi	1
метро митино	personal_assistant.scenarios.find_poi	1
метро отрадное	personal_assistant.scenarios.find_poi	1
митино	personal_assistant.scenarios.find_poi	1
метро строгино	personal_assistant.scenarios.find_poi	1
мкад	personal_assistant.scenarios.find_poi	1
метро дубровка	personal_assistant.scenarios.find_poi	1
шиномонтаж	personal_assistant.scenarios.find_poi	1
метро бабушкинская	personal_assistant.scenarios.find_poi	1
город королев	personal_assistant.scenarios.find_poi	1
метро домодедово	personal_assistant.scenarios.find_poi	1
метро кожуховская	personal_assistant.scenarios.find_poi	1
аптека	personal_assistant.scenarios.find_poi	1
екатеринбург	personal_assistant.scenarios.find_poi	1
охотный ряд	personal_assistant.scenarios.find_poi	1
красная площадь	personal_assistant.scenarios.find_poi	1
метро сходненская	personal_assistant.scenarios.find_poi	1
метро динамо	personal_assistant.scenarios.find_poi	1
невский проспект	personal_assistant.scenarios.find_poi	1
пулково	personal_assistant.scenarios.find_poi	1
самара	personal_assistant.scenarios.find_poi	1
магазин пятерочка	personal_assistant.scenarios.find_poi	1
заправка лукойл	personal_assistant.scenarios.find_poi	1
реутов	personal_assistant.scenarios.find_poi	1
внуково	personal_assistant.scenarios.find_poi	1
лобня	personal_assistant.scenarios.find_poi	1
метро кантемировская	personal_assistant.scenarios.find_poi	1
кутузовский проспект	personal_assistant.scenarios.find_poi	1
столовая	personal_assistant.scenarios.find_poi	1
ярославль	personal_assistant.scenarios.find_poi	1
банкомат сбербанк	personal_assistant.scenarios.find_poi	1
автозапчасти	personal_assistant.scenarios.find_poi	1
волгоград	personal_assistant.scenarios.find_poi	1
метро бауманская	personal_assistant.scenarios.find_poi	1
тверь	personal_assistant.scenarios.find_poi	1
метро планерная	personal_assistant.scenarios.find_poi	1
тверская	personal_assistant.scenarios.find_poi	1
метро киевская	personal_assistant.scenarios.find_poi	1
метро октябрьское поле	personal_assistant.scenarios.find_poi	1
ульяновск	personal_assistant.scenarios.find_poi	1
метро алексеевская	personal_assistant.scenarios.find_poi	1
метро профсоюзная	personal_assistant.scenarios.find_poi	1
теплый стан	personal_assistant.scenarios.find_poi	1
солнечногорск	personal_assistant.scenarios.find_poi	1
город видное	personal_assistant.scenarios.find_poi	1
тверская улица	personal_assistant.scenarios.find_poi	1
коломна	personal_assistant.scenarios.find_poi	1
коммунарка	personal_assistant.scenarios.find_poi	1
метро парнас	personal_assistant.scenarios.find_poi	1
владимир	personal_assistant.scenarios.find_poi	1
саратов	personal_assistant.scenarios.find_poi	1
метро семеновская	personal_assistant.scenarios.find_poi	1
метро саларьево	personal_assistant.scenarios.find_poi	1
колпино	personal_assistant.scenarios.find_poi	1
метро полежаевская	personal_assistant.scenarios.find_poi	1
апрелевка	personal_assistant.scenarios.find_poi	1
город подольск	personal_assistant.scenarios.find_poi	1
заправка газпром	personal_assistant.scenarios.find_poi	1
метро площадь ильича	personal_assistant.scenarios.find_poi	1
орехово зуево	personal_assistant.scenarios.find_poi	1
метро партизанская	personal_assistant.scenarios.find_poi	1
город	personal_assistant.scenarios.find_poi	1
калуга	personal_assistant.scenarios.find_poi	1
метро московская	personal_assistant.scenarios.find_poi	1
деловые линии	personal_assistant.scenarios.find_poi	1
челябинск	personal_assistant.scenarios.find_poi	1
элекснет	personal_assistant.scenarios.find_poi	1
чехов	personal_assistant.scenarios.find_poi	1
новосибирск	personal_assistant.scenarios.find_poi	1
метро проспект мира	personal_assistant.scenarios.find_poi	1
дмитров	personal_assistant.scenarios.find_poi	1
город мытищи	personal_assistant.scenarios.find_poi	1
метро звездная	personal_assistant.scenarios.find_poi	1
метро волгоградский проспект	personal_assistant.scenarios.find_poi	1
нахабино	personal_assistant.scenarios.find_poi	1
метро озерки	personal_assistant.scenarios.find_poi	1
серпухов	personal_assistant.scenarios.find_poi	1
люблино	personal_assistant.scenarios.find_poi	1
сочи	personal_assistant.scenarios.find_poi	1
волгоградский проспект	personal_assistant.scenarios.find_poi	1
гостиница украина	personal_assistant.scenarios.find_poi	1
азс роснефть	personal_assistant.scenarios.find_poi	1
садовое кольцо	personal_assistant.scenarios.find_poi	1
домодедово аэропорт	personal_assistant.scenarios.find_poi	1
гатчина	personal_assistant.scenarios.find_poi	1
мойка	personal_assistant.scenarios.find_poi	1
метро купчино	personal_assistant.scenarios.find_poi	1
пенза	personal_assistant.scenarios.find_poi	1
варшавское шоссе	personal_assistant.scenarios.find_poi	1
новокосино	personal_assistant.scenarios.find_poi	1
котельники	personal_assistant.scenarios.find_poi	1
китай город	personal_assistant.scenarios.find_poi	1
метро тимирязевская	personal_assistant.scenarios.find_poi	1
мега	personal_assistant.scenarios.find_poi	1
газпром	personal_assistant.scenarios.find_poi	1
банкомат сбербанка	personal_assistant.scenarios.find_poi	1
метро новые черемушки	personal_assistant.scenarios.find_poi	1
кафе	personal_assistant.scenarios.find_poi	1
белая дача	personal_assistant.scenarios.find_poi	1
нотариус	personal_assistant.scenarios.find_poi	1
рязанский проспект	personal_assistant.scenarios.find_poi	1
город щелково	personal_assistant.scenarios.find_poi	1
тамбов	personal_assistant.scenarios.find_poi	1
новороссийск	personal_assistant.scenarios.find_poi	1
набережные челны	personal_assistant.scenarios.find_poi	1
торговый центр европейский	personal_assistant.scenarios.find_poi	1
торговый центр	personal_assistant.scenarios.find_poi	1
железнодорожный	personal_assistant.scenarios.find_poi	1
фикс прайс	personal_assistant.scenarios.find_poi	1
метро ховрино	personal_assistant.scenarios.find_poi	1
арбат	personal_assistant.scenarios.find_poi	1
комсомольская площадь	personal_assistant.scenarios.find_poi	1
метро савеловская	personal_assistant.scenarios.find_poi	1
ставрополь	personal_assistant.scenarios.find_poi	1
метро калужская	personal_assistant.scenarios.find_poi	1
воскресенск	personal_assistant.scenarios.find_poi	1
мфц	personal_assistant.scenarios.find_poi	1
метро дмитровская	personal_assistant.scenarios.find_poi	1
город пушкино	personal_assistant.scenarios.find_poi	1
шоссе энтузиастов	personal_assistant.scenarios.find_poi	1
город дмитров	personal_assistant.scenarios.find_poi	1
метро беговая	personal_assistant.scenarios.find_poi	1
метро фрунзенская	personal_assistant.scenarios.find_poi	1
фрязино	personal_assistant.scenarios.find_poi	1
сертолово	personal_assistant.scenarios.find_poi	1
пермь	personal_assistant.scenarios.find_poi	1
авиапарк	personal_assistant.scenarios.find_poi	1
мега парнас	personal_assistant.scenarios.find_poi	1
бизнес парк румянцево	personal_assistant.scenarios.find_poi	1
оренбург	personal_assistant.scenarios.find_poi	1
метро ладожская	personal_assistant.scenarios.find_poi	1
преображенская площадь	personal_assistant.scenarios.find_poi	1
метро фили	personal_assistant.scenarios.find_poi	1
город краснодар	personal_assistant.scenarios.find_poi	1
минск	personal_assistant.scenarios.find_poi	1
метро курская	personal_assistant.scenarios.find_poi	1
липецк	personal_assistant.scenarios.find_poi	1
самомойка	personal_assistant.scenarios.find_poi	1
великий новгород	personal_assistant.scenarios.find_poi	1
метро девяткино	personal_assistant.scenarios.find_poi	1
тольятти	personal_assistant.scenarios.find_poi	1
шушары	personal_assistant.scenarios.find_poi	1
южные ворота	personal_assistant.scenarios.find_poi	1
климовск	personal_assistant.scenarios.find_poi	1
метро октябрьская	personal_assistant.scenarios.find_poi	1
московский	personal_assistant.scenarios.find_poi	1
щелковское шоссе	personal_assistant.scenarios.find_poi	1
ступино	personal_assistant.scenarios.find_poi	1
отделение сбербанка	personal_assistant.scenarios.find_poi	1
алтуфьевское шоссе	personal_assistant.scenarios.find_poi	1
белгород	personal_assistant.scenarios.find_poi	1
перекресток	personal_assistant.scenarios.find_poi	1
город зеленоград	personal_assistant.scenarios.find_poi	1
почта россии	personal_assistant.scenarios.find_poi	1
южное бутово	personal_assistant.scenarios.find_poi	1
аэропорт пулково 1	personal_assistant.scenarios.find_poi	1
метро анино	personal_assistant.scenarios.find_poi	1
метро маяковская	personal_assistant.scenarios.find_poi	1
метро парк победы	personal_assistant.scenarios.find_poi	1
метро просвещения	personal_assistant.scenarios.find_poi	1
махачкала	personal_assistant.scenarios.find_poi	1
румянцево	personal_assistant.scenarios.find_poi	1
автосервис	personal_assistant.scenarios.find_poi	1
азс шелл	personal_assistant.scenarios.find_poi	1
метро рыбацкое	personal_assistant.scenarios.find_poi	1
мой сам	personal_assistant.scenarios.find_poi	1
заправка газпромнефть	personal_assistant.scenarios.find_poi	1
метро чертановская	personal_assistant.scenarios.find_poi	1
сходня	personal_assistant.scenarios.find_poi	1
поселок	personal_assistant.scenarios.find_poi	1
метро пушкинская	personal_assistant.scenarios.find_poi	1
евросеть	personal_assistant.scenarios.find_poi	1
метро гражданский проспект	personal_assistant.scenarios.find_poi	1
вегас	personal_assistant.scenarios.find_poi	1
псков	personal_assistant.scenarios.find_poi	1
егорьевск	personal_assistant.scenarios.find_poi	1
метро ветеранов	personal_assistant.scenarios.find_poi	1
хованское кладбище	personal_assistant.scenarios.find_poi	1
город балашиха	personal_assistant.scenarios.find_poi	1
максидом	personal_assistant.scenarios.find_poi	1
рижский вокзал	personal_assistant.scenarios.find_poi	1
окей	personal_assistant.scenarios.find_poi	1
вологда	personal_assistant.scenarios.find_poi	1
яндекс	personal_assistant.scenarios.find_poi	1
таганская площадь	personal_assistant.scenarios.find_poi	1
курск	personal_assistant.scenarios.find_poi	1
медведково	personal_assistant.scenarios.find_poi	1
боровское шоссе	personal_assistant.scenarios.find_poi	1
ленинградский проспект	personal_assistant.scenarios.find_poi	1
метро тушино	personal_assistant.scenarios.find_poi	1
красноярск	personal_assistant.scenarios.find_poi	1
строительный магазин	personal_assistant.scenarios.find_poi	1
метро шоссе энтузиастов	personal_assistant.scenarios.find_poi	1
мытищинская ярмарка	personal_assistant.scenarios.find_poi	1
азс бипи	personal_assistant.scenarios.find_poi	1
дзержинского 100	personal_assistant.scenarios.find_poi	1
метро лесная	personal_assistant.scenarios.find_poi	1
геленджик	personal_assistant.scenarios.find_poi	1
жулебино	personal_assistant.scenarios.find_poi	1
краснопресненская набережная дом 12	personal_assistant.scenarios.find_poi	1
метро черная речка	personal_assistant.scenarios.find_poi	1
кфс	personal_assistant.scenarios.find_poi	1
киров	personal_assistant.scenarios.find_poi	1
город дзержинский	personal_assistant.scenarios.find_poi	1
площадь ильича	personal_assistant.scenarios.find_poi	1
рынок	personal_assistant.scenarios.find_poi	1
крекшино	personal_assistant.scenarios.find_poi	1
азбука вкуса	personal_assistant.scenarios.find_poi	1
татнефть	personal_assistant.scenarios.find_poi	1
пэк	personal_assistant.scenarios.find_poi	1
владикавказ	personal_assistant.scenarios.find_poi	1
метро щелково	personal_assistant.scenarios.find_poi	1
внуково аэропорт	personal_assistant.scenarios.find_poi	1
астрахань	personal_assistant.scenarios.find_poi	1
галерея	personal_assistant.scenarios.find_poi	1
шереметьево аэропорт	personal_assistant.scenarios.find_poi	1
рябиновая 45	personal_assistant.scenarios.find_poi	1
ясенево	personal_assistant.scenarios.find_poi	1
армавир	personal_assistant.scenarios.find_poi	1
метро бульвар дмитрия донского	personal_assistant.scenarios.find_poi	1
пресненская набережная 2	personal_assistant.scenarios.find_poi	1
цветы	personal_assistant.scenarios.find_poi	1
московская область	personal_assistant.scenarios.find_poi	1
выборг	personal_assistant.scenarios.find_poi	1
краснознаменск	personal_assistant.scenarios.find_poi	1
аптека 24 часа	personal_assistant.scenarios.find_poi	1
конгрессная 1	personal_assistant.scenarios.find_poi	1
электроугли	personal_assistant.scenarios.find_poi	1
таганрог	personal_assistant.scenarios.find_poi	1
путилково	personal_assistant.scenarios.find_poi	1
шереметьево терминал ф	personal_assistant.scenarios.find_poi	1
метро ботанический сад	personal_assistant.scenarios.find_poi	1
монино	personal_assistant.scenarios.find_poi	1
метро чкаловская	personal_assistant.scenarios.find_poi	1
деревня сахарово	personal_assistant.scenarios.find_poi	1
центральный рынок	personal_assistant.scenarios.find_poi	1
мосрентген	personal_assistant.scenarios.find_poi	1
золотой вавилон	personal_assistant.scenarios.find_poi	1
савушкина 103	personal_assistant.scenarios.find_poi	1
дубровка	personal_assistant.scenarios.find_poi	1
город троицк	personal_assistant.scenarios.find_poi	1
мега адыгея	personal_assistant.scenarios.find_poi	1
пятницкое шоссе	personal_assistant.scenarios.find_poi	1
ереван	personal_assistant.scenarios.find_poi	1
метро ломоносовская	personal_assistant.scenarios.find_poi	1
град московский	personal_assistant.scenarios.find_poi	1
город красногорск	personal_assistant.scenarios.find_poi	1
новочеркасск	personal_assistant.scenarios.find_poi	1
марьина роща	personal_assistant.scenarios.find_poi	1
41 километр мкад	personal_assistant.scenarios.find_poi	1
грозный	personal_assistant.scenarios.find_poi	1
орел	personal_assistant.scenarios.find_poi	1
коровинское шоссе	personal_assistant.scenarios.find_poi	1
можайское шоссе	personal_assistant.scenarios.find_poi	1
новорижское шоссе	personal_assistant.scenarios.find_poi	1
транспортная компания пэк	personal_assistant.scenarios.find_poi	1
метро 1905 года	personal_assistant.scenarios.find_poi	1
молоково	personal_assistant.scenarios.find_poi	1
продуктовый магазин	personal_assistant.scenarios.find_poi	1
метро мякинино	personal_assistant.scenarios.find_poi	1
курган	personal_assistant.scenarios.find_poi	1
волгоградский проспект 32	personal_assistant.scenarios.find_poi	1
совхоз имени ленина	personal_assistant.scenarios.find_poi	1
пресненская набережная 10	personal_assistant.scenarios.find_poi	1
центр	personal_assistant.scenarios.find_poi	1
икея химки	personal_assistant.scenarios.find_poi	1
микрорайон 1 мая	personal_assistant.scenarios.find_poi	1
город серпухов	personal_assistant.scenarios.find_poi	1
проспект просвещения	personal_assistant.scenarios.find_poi	1
сигнальный проезд	personal_assistant.scenarios.find_poi	1
нальчик	personal_assistant.scenarios.find_poi	1
метро новокузнецкая	personal_assistant.scenarios.find_poi	1
город ярославль	personal_assistant.scenarios.find_poi	1
город иваново	personal_assistant.scenarios.find_poi	1
магазин лента	personal_assistant.scenarios.find_poi	1
заправка шелл	personal_assistant.scenarios.find_poi	1
дубна	personal_assistant.scenarios.find_poi	1
лосино петровский	personal_assistant.scenarios.find_poi	1
метро автово	personal_assistant.scenarios.find_poi	1
магазин перекресток	personal_assistant.scenarios.find_poi	1
туалет	personal_assistant.scenarios.find_poi	1
парк победы	personal_assistant.scenarios.find_poi	1
янино 1	personal_assistant.scenarios.find_poi	1
метро приморская	personal_assistant.scenarios.find_poi	1
город бронницы	personal_assistant.scenarios.find_poi	1
барнаул	personal_assistant.scenarios.find_poi	1
парикмахерская	personal_assistant.scenarios.find_poi	1
метро чернышевская	personal_assistant.scenarios.find_poi	1
пресненская набережная дом 2	personal_assistant.scenarios.find_poi	1
петрозаводск	personal_assistant.scenarios.find_poi	1
софийская 60	personal_assistant.scenarios.find_poi	1
сокольники	personal_assistant.scenarios.find_poi	1
горбушка	personal_assistant.scenarios.find_poi	1
павшинская пойма	personal_assistant.scenarios.find_poi	1
сызрань	personal_assistant.scenarios.find_poi	1
барвиха	personal_assistant.scenarios.find_poi	1
метро нарвская	personal_assistant.scenarios.find_poi	1
каширское шоссе 23	personal_assistant.scenarios.find_poi	1
сахарова	personal_assistant.scenarios.find_poi	1
марусино	personal_assistant.scenarios.find_poi	1
янино	personal_assistant.scenarios.find_poi	1
улица ленина	personal_assistant.scenarios.find_poi	1
школа	personal_assistant.scenarios.find_poi	1
немчиновка	personal_assistant.scenarios.find_poi	1
дорогомиловский рынок	personal_assistant.scenarios.find_poi	1
привокзальная площадь 1	personal_assistant.scenarios.find_poi	1
калужское шоссе	personal_assistant.scenarios.find_poi	1
метро новочеркасская	personal_assistant.scenarios.find_poi	1
парк хаус	personal_assistant.scenarios.find_poi	1
автомагазин	personal_assistant.scenarios.find_poi	1
икша	personal_assistant.scenarios.find_poi	1
город орел	personal_assistant.scenarios.find_poi	1
керчь	personal_assistant.scenarios.find_poi	1
луховицы	personal_assistant.scenarios.find_poi	1
город раменское	personal_assistant.scenarios.find_poi	1
втб	personal_assistant.scenarios.find_poi	1
международный аэропорт внуково	personal_assistant.scenarios.find_poi	1
метро багратионовская	personal_assistant.scenarios.find_poi	1
аэропорт жуково	personal_assistant.scenarios.find_poi	1
мкад 41 километр	personal_assistant.scenarios.find_poi	1
рублевское шоссе	personal_assistant.scenarios.find_poi	1
тучково	personal_assistant.scenarios.find_poi	1
метро зябликово	personal_assistant.scenarios.find_poi	1
кашира	personal_assistant.scenarios.find_poi	1
метро горьковская	personal_assistant.scenarios.find_poi	1
банкомат втб	personal_assistant.scenarios.find_poi	1
академика королева 12	personal_assistant.scenarios.find_poi	1
гостиный двор	personal_assistant.scenarios.find_poi	1
почта банк	personal_assistant.scenarios.find_poi	1
бипи	personal_assistant.scenarios.find_poi	1
город ульяновск	personal_assistant.scenarios.find_poi	1
порт кавказ	personal_assistant.scenarios.find_poi	1
мкад 14 километр	personal_assistant.scenarios.find_poi	1
трехгорка	personal_assistant.scenarios.find_poi	1
балабаново	personal_assistant.scenarios.find_poi	1
метро чертаново	personal_assistant.scenarios.find_poi	1
кунцевский авторынок	personal_assistant.scenarios.find_poi	1
усть лабинск	personal_assistant.scenarios.find_poi	1
олимпийский проспект	personal_assistant.scenarios.find_poi	1
горячий ключ	personal_assistant.scenarios.find_poi	1
метро измайловская	personal_assistant.scenarios.find_poi	1
ялта	personal_assistant.scenarios.find_poi	1
мурманск	personal_assistant.scenarios.find_poi	1
хутор ленина	personal_assistant.scenarios.find_poi	1
щелковское шоссе дом 100	personal_assistant.scenarios.find_poi	1
говори	personal_assistant.scenarios.find_poi	1
транспортная компания кит	personal_assistant.scenarios.find_poi	1
новорязанское шоссе	personal_assistant.scenarios.find_poi	1
иркутск	personal_assistant.scenarios.find_poi	1
кингисепп	personal_assistant.scenarios.find_poi	1
станция люберцы	personal_assistant.scenarios.find_poi	1
поселок мосрентген	personal_assistant.scenarios.find_poi	1
метро академика янгеля	personal_assistant.scenarios.find_poi	1
тимашевск	personal_assistant.scenarios.find_poi	1
волгодонск	personal_assistant.scenarios.find_poi	1
северное бутово	personal_assistant.scenarios.find_poi	1
торговый центр мега	personal_assistant.scenarios.find_poi	1
туапсе	personal_assistant.scenarios.find_poi	1
красного текстильщика 10	personal_assistant.scenarios.find_poi	1
торговый центр вегас	personal_assistant.scenarios.find_poi	1
тверская 7	personal_assistant.scenarios.find_poi	1
европейский	personal_assistant.scenarios.find_poi	1
вешки	personal_assistant.scenarios.find_poi	1
адрес	personal_assistant.scenarios.find_poi	1
метро комендантский проспект	personal_assistant.scenarios.find_poi	1
аптека озерки	personal_assistant.scenarios.find_poi	1
маршала жукова	personal_assistant.scenarios.find_poi	1
парнас	personal_assistant.scenarios.find_poi	1
чапаевский переулок дом 3	personal_assistant.scenarios.find_poi	1
сбс	personal_assistant.scenarios.find_poi	1
руза	personal_assistant.scenarios.find_poi	1
банк втб	personal_assistant.scenarios.find_poi	1
деревня грибки	personal_assistant.scenarios.find_poi	1
царицыно	personal_assistant.scenarios.find_poi	1
поселок володарского	personal_assistant.scenarios.find_poi	1
выхино	personal_assistant.scenarios.find_poi	1
пресненская набережная 8 строение 1	personal_assistant.scenarios.find_poi	1
беседы	personal_assistant.scenarios.find_poi	1
красно белое	personal_assistant.scenarios.find_poi	1
станция метро	personal_assistant.scenarios.find_poi	1
магазин метро	personal_assistant.scenarios.find_poi	1
южное шоссе 37	personal_assistant.scenarios.find_poi	1
ташкент	personal_assistant.scenarios.find_poi	1
метро красные ворота	personal_assistant.scenarios.find_poi	1
город воскресенск	personal_assistant.scenarios.find_poi	1
купчино	personal_assistant.scenarios.find_poi	1
город ивантеевка	personal_assistant.scenarios.find_poi	1
метрополис	personal_assistant.scenarios.find_poi	1
профсоюзная 56	personal_assistant.scenarios.find_poi	1
торговый центр галерея	personal_assistant.scenarios.find_poi	1
метро обводный канал	personal_assistant.scenarios.find_poi	1
мосфильмовская 88	personal_assistant.scenarios.find_poi	1
город волгоград	personal_assistant.scenarios.find_poi	1
метро серпуховская	personal_assistant.scenarios.find_poi	1
пресненская набережная дом 12	personal_assistant.scenarios.find_poi	1
ресторан	personal_assistant.scenarios.find_poi	1
метро площадь восстания	personal_assistant.scenarios.find_poi	1
афимолл	personal_assistant.scenarios.find_poi	1
коровинское шоссе дом 35	personal_assistant.scenarios.find_poi	1
косыгина 21	personal_assistant.scenarios.find_poi	1
токсово	personal_assistant.scenarios.find_poi	1
аутлет белая дача	personal_assistant.scenarios.find_poi	1
метро кэш энд керри	personal_assistant.scenarios.find_poi	1
новомосковск	personal_assistant.scenarios.find_poi	1
город уфа	personal_assistant.scenarios.find_poi	1
икея теплый стан	personal_assistant.scenarios.find_poi	1
оружейный переулок 41	personal_assistant.scenarios.find_poi	1
город климовск	personal_assistant.scenarios.find_poi	1
александров	personal_assistant.scenarios.find_poi	1
киевская 27	personal_assistant.scenarios.find_poi	1
аэропорт шереметьево д	personal_assistant.scenarios.find_poi	1
ленинский проспект 117	personal_assistant.scenarios.find_poi	1
белореченск	personal_assistant.scenarios.find_poi	1
метро полянка	personal_assistant.scenarios.find_poi	1
город ростов на дону	personal_assistant.scenarios.find_poi	1
бескудниковский бульвар	personal_assistant.scenarios.find_poi	1
заправки	personal_assistant.scenarios.find_poi	1
торговый центр рио	personal_assistant.scenarios.find_poi	1
самообслуживание мойка	personal_assistant.scenarios.find_poi	1
томск	personal_assistant.scenarios.find_poi	1
гранд каньон	personal_assistant.scenarios.find_poi	1
метро севастопольская	personal_assistant.scenarios.find_poi	1
метро марксистская	personal_assistant.scenarios.find_poi	1
кавказский бульвар 57	personal_assistant.scenarios.find_poi	1
ресторан яндекс	personal_assistant.scenarios.find_poi	1
буден компьютерный рынок	personal_assistant.scenarios.find_poi	1
союз снаб	personal_assistant.scenarios.find_poi	1
раменский район снт корпоратив	personal_assistant.scenarios.find_poi	1
золото 585	personal_assistant.scenarios.find_poi	1
европа	personal_assistant.scenarios.find_poi	1
станция метро маяковская	personal_assistant.scenarios.find_poi	1
окко ока	personal_assistant.scenarios.find_poi	1
аэропорт шереметьево	personal_assistant.scenarios.find_poi	1
кокорай 77 / 1	personal_assistant.scenarios.find_poi	1
восьмой новоподмосковный проезд три	personal_assistant.scenarios.find_poi	1
поселение киевский	personal_assistant.scenarios.find_poi	1
дворец султана	personal_assistant.scenarios.find_poi	1
офис везет	personal_assistant.scenarios.find_poi	1
метро марксистская	personal_assistant.scenarios.find_poi	1
город режа жд вокзал	personal_assistant.scenarios.find_poi	1
газель бизнес где находится	personal_assistant.scenarios.find_poi	1
ильинка	personal_assistant.scenarios.find_poi	1
бавлы пятерочки	personal_assistant.scenarios.find_poi	1
бутиковский переулок	personal_assistant.scenarios.find_poi	1
престиж	personal_assistant.scenarios.find_poi	1
вэб лизинг до московской	personal_assistant.scenarios.find_poi	1
маршала катукова	personal_assistant.scenarios.find_poi	1
ледино где находится	personal_assistant.scenarios.find_poi	1
город рыбинск улица расторгуева дом 6 магазин красно белое	personal_assistant.scenarios.find_poi	1
библиотека имени лермонтова	personal_assistant.scenarios.find_poi	1
поворот на молоково	personal_assistant.scenarios.find_poi	1
город ейск	personal_assistant.scenarios.find_poi	1
проезд таганский пятнадцать	personal_assistant.scenarios.find_poi	1
тичини офис	personal_assistant.scenarios.find_poi	1
ттк макслевел	personal_assistant.scenarios.find_poi	1
обл гаи пост дпс тула	personal_assistant.scenarios.find_poi	1
поселок михеевка где находится	personal_assistant.scenarios.find_poi	1
моисеенко	personal_assistant.scenarios.find_poi	1
арейское	personal_assistant.scenarios.find_poi	1
сабвей круглосуточно	personal_assistant.scenarios.find_poi	1
симферополь	personal_assistant.scenarios.find_poi	1
салон вижу все	personal_assistant.scenarios.find_poi	1
71 лицей	personal_assistant.scenarios.find_poi	1
коломна	personal_assistant.scenarios.find_poi	1
заправка шелл	personal_assistant.scenarios.find_poi	1
территория технопарка сынково	personal_assistant.scenarios.find_poi	1
карта омска	personal_assistant.scenarios.find_poi	1
смартори	personal_assistant.scenarios.find_poi	1
жк альботрос	personal_assistant.scenarios.find_poi	1
лужнецкая набережная	personal_assistant.scenarios.find_poi	1
промышленный проезд	personal_assistant.scenarios.find_poi	1
рам имени гнесиных	personal_assistant.scenarios.find_poi	1
кубинка	personal_assistant.scenarios.find_poi	1
улица победы дом 2 / 18 магазин пятерочка	personal_assistant.scenarios.find_poi	1
театр леси украинки	personal_assistant.scenarios.find_poi	1
тесла плейс	personal_assistant.scenarios.find_poi	1
театр буфф на лесной	personal_assistant.scenarios.find_poi	1
город долгопрудный	personal_assistant.scenarios.find_poi	1
банкомат сбербанка двадцать четыре часа	personal_assistant.scenarios.find_poi	1
грузовой терминал аэропорта шереметьево	personal_assistant.scenarios.find_poi	1
наметкина	personal_assistant.scenarios.find_poi	1
юриш 4 линия 31	personal_assistant.scenarios.find_poi	1
тойота отрадное	personal_assistant.scenarios.find_poi	1
25 километр мкада конструктор	personal_assistant.scenarios.find_poi	1
горький 2 успенский рейс	personal_assistant.scenarios.find_poi	1
88 километр по м 2 трасса	personal_assistant.scenarios.find_poi	1
арис центр	personal_assistant.scenarios.find_poi	1
город дедовск	personal_assistant.scenarios.find_poi	1
аксайский поворот	personal_assistant.scenarios.find_poi	1
тверская	personal_assistant.scenarios.find_poi	1
мотели с парковки для грузовиков	personal_assistant.scenarios.find_poi	1
офис такси везет	personal_assistant.scenarios.find_poi	1
мотель б	personal_assistant.scenarios.find_poi	1
гастро ферма	personal_assistant.scenarios.find_poi	1
платформа томилино	personal_assistant.scenarios.find_poi	1
городец новая 112	personal_assistant.scenarios.find_poi	1
таджикский десять	personal_assistant.scenarios.find_poi	1
вторая брестская тридцать	personal_assistant.scenarios.find_poi	1
коровий вал дом пять в рот тебя и б	personal_assistant.scenarios.find_poi	1
цирк тамак	personal_assistant.scenarios.find_poi	1
троицк леруа	personal_assistant.scenarios.find_poi	1
город мытищи	personal_assistant.scenarios.find_poi	1
апрелевка наро фоминский район	personal_assistant.scenarios.find_poi	1
почта банк	personal_assistant.scenarios.find_poi	1
покажи в новой кирилловская сорок	personal_assistant.scenarios.find_poi	1
кожевник два	personal_assistant.scenarios.find_poi	1
мкад восемнадцатый километр	personal_assistant.scenarios.find_poi	1
аэротель домодедово	personal_assistant.scenarios.find_poi	1
мебель ван	personal_assistant.scenarios.find_poi	1
народного ополчения	personal_assistant.scenarios.find_poi	1
дом маляра	personal_assistant.scenarios.find_poi	1
метро тысяча девятьсот пятого года	personal_assistant.scenarios.find_poi	1
верхняя сыромятническая	personal_assistant.scenarios.find_poi	1
4 педагогический колледж	personal_assistant.scenarios.find_poi	1
шаран больница	personal_assistant.scenarios.find_poi	1
станция пролетарская	personal_assistant.scenarios.find_poi	1
город майкоп лагонаки	personal_assistant.scenarios.find_poi	1
ашан	personal_assistant.scenarios.find_poi	1
империя	personal_assistant.scenarios.find_poi	1
вторая брестская	personal_assistant.scenarios.find_poi	1
метро нарвская	personal_assistant.scenarios.find_poi	1
павелецкий вокзал жд	personal_assistant.scenarios.find_poi	1
район соколиная гора	personal_assistant.scenarios.find_poi	1
аллея витте дом два	personal_assistant.scenarios.find_poi	1
21 километр торговый центр мега	personal_assistant.scenarios.find_poi	1
астрея	personal_assistant.scenarios.find_poi	1
новая ольховка	personal_assistant.scenarios.find_poi	1
тц xl ярославское шоссе	personal_assistant.scenarios.find_poi	1
метро шереметьево	personal_assistant.scenarios.find_poi	1
большая тульская метро	personal_assistant.scenarios.find_poi	1
барс на попова	personal_assistant.scenarios.find_poi	1
мирской переулок	personal_assistant.scenarios.find_poi	1
метизы на фонтанке	personal_assistant.scenarios.find_poi	1
7 7 вольво электрозаводская	personal_assistant.scenarios.find_poi	1
цветалета дом четыре корпус	personal_assistant.scenarios.find_poi	1
сша где находится	personal_assistant.scenarios.find_poi	1
москва климов	personal_assistant.scenarios.find_poi	1
павелецкая набережная	personal_assistant.scenarios.find_poi	1
метро шоссе энтузиастов	personal_assistant.scenarios.find_poi	1
где находится америка	personal_assistant.scenarios.find_poi	1
лежена 12 / 1	personal_assistant.scenarios.find_poi	1
икеа	personal_assistant.scenarios.find_poi	1
одинцово	personal_assistant.scenarios.find_poi	1
город каспийск	personal_assistant.scenarios.find_poi	1
проспект салават юлаев двадцать четыре	personal_assistant.scenarios.find_poi	1
прогимназия свиблово	personal_assistant.scenarios.find_poi	1
деревня синево	personal_assistant.scenarios.find_poi	1
город нахабино	personal_assistant.scenarios.find_poi	1
тульский метро	personal_assistant.scenarios.find_poi	1
сапсан арена стадион	personal_assistant.scenarios.find_poi	1
метро марьино	personal_assistant.scenarios.find_poi	1
ям тесовское поселение	personal_assistant.scenarios.find_poi	1
росал	personal_assistant.scenarios.find_poi	1
старый пост ям ижора	personal_assistant.scenarios.find_poi	1
88 газпромнефть	personal_assistant.scenarios.find_poi	1
метро пражский	personal_assistant.scenarios.find_poi	1
москва	personal_assistant.scenarios.find_poi	1
третий крутицкий	personal_assistant.scenarios.find_poi	1
моэк	personal_assistant.scenarios.find_poi	1
марьино	personal_assistant.scenarios.find_poi	1
воронеж	personal_assistant.scenarios.find_poi	1
псковское шоссе	personal_assistant.scenarios.find_poi	1
чоботовская	personal_assistant.scenarios.find_poi	1
москва останкино	personal_assistant.scenarios.find_poi	1
куликово поле где находится	personal_assistant.scenarios.find_poi	1
газ газэнергобанк	personal_assistant.scenarios.find_poi	1
улица шировский поворот игрушки	personal_assistant.scenarios.find_poi	1
кольцевая двадцать	personal_assistant.scenarios.find_poi	1
приморский тридцать один	personal_assistant.scenarios.find_poi	1
управление внутренних дел по солнечногорскому району	personal_assistant.scenarios.find_poi	1
эльбрус запчасти	personal_assistant.scenarios.find_poi	1
икея	personal_assistant.scenarios.find_poi	1
мароновский переулок	personal_assistant.scenarios.find_poi	1
лежена 9 / 1	personal_assistant.scenarios.find_poi	1
сущевский вал 21 арт лайф	personal_assistant.scenarios.find_poi	1
первая брестская	personal_assistant.scenarios.find_poi	1
метро улица дыбенко	personal_assistant.scenarios.find_poi	1
рынок сенной	personal_assistant.scenarios.find_poi	1
москва кинза нея	personal_assistant.scenarios.find_poi	1
лежена 28 / 1	personal_assistant.scenarios.find_poi	1
витражная суд	personal_assistant.scenarios.find_poi	1
легенда дальневосточный	personal_assistant.scenarios.find_poi	1
метро спортивная	personal_assistant.scenarios.find_poi	1
южный форт	personal_assistant.scenarios.find_poi	1
республика адыгея мезмай	personal_assistant.scenarios.find_poi	1
наманган ставропольская	personal_assistant.scenarios.find_poi	1
снт дипломат московская область	personal_assistant.scenarios.find_poi	1
большая тульская	personal_assistant.scenarios.find_poi	1
нагинский дпс	personal_assistant.scenarios.find_poi	1
пив энд ко	personal_assistant.scenarios.find_poi	1
заправиться	personal_assistant.scenarios.find_poi	1
тарлан авто	personal_assistant.scenarios.find_poi	1
нетбайнет	personal_assistant.scenarios.find_poi	1
метро жулебино	personal_assistant.scenarios.find_poi	1
порт оля	personal_assistant.scenarios.find_poi	1
несте express	personal_assistant.scenarios.find_poi	1
маяк системы безопасности	personal_assistant.scenarios.find_poi	1
рц лобня перекресток	personal_assistant.scenarios.find_poi	1
лежена 5 / 1	personal_assistant.scenarios.find_poi	1
71 километр мкад тц окей	personal_assistant.scenarios.find_poi	1
карсити где находится	personal_assistant.scenarios.find_poi	1
платформа жавринка	personal_assistant.scenarios.find_poi	1
химки	personal_assistant.scenarios.find_poi	1
курилово	personal_assistant.scenarios.find_poi	1
пришвина владение два	personal_assistant.scenarios.find_poi	1
путевой проезд пятьдесят два	personal_assistant.scenarios.find_poi	1
новгород хлеб	personal_assistant.scenarios.find_poi	1
город москва рижский проезд дом 7 магазин бим	personal_assistant.scenarios.find_poi	1
2 оперативный полк	personal_assistant.scenarios.find_poi	1
башня меркурий	personal_assistant.scenarios.find_poi	1
обводного канала пересечение митрофановское шоссе	personal_assistant.scenarios.find_poi	1
театр советской армии	personal_assistant.scenarios.find_poi	1
кфс сказал что	personal_assistant.scenarios.find_poi	1
лежена 10 / 1	personal_assistant.scenarios.find_poi	1
смотровая площадка	personal_assistant.scenarios.find_poi	1
международный аэропорт внуково терминал а	personal_assistant.scenarios.find_poi	1
32 километр внешняя сторона пежо центр	personal_assistant.scenarios.find_poi	1
тро коламбус	personal_assistant.scenarios.find_poi	1
Коломна 	personal_assistant.scenarios.find_poi	1
сбербанк	personal_assistant.scenarios.find_poi	1
тарас бульба алексеевская	personal_assistant.scenarios.find_poi	1
коломенский проезд четыре	personal_assistant.scenarios.find_poi	1
станция виноградова	personal_assistant.scenarios.find_poi	1
метро шоссе интузиастов	personal_assistant.scenarios.find_poi	1
карго страховая	personal_assistant.scenarios.find_poi	1
открой карту одинцово	personal_assistant.scenarios.find_poi	1
тульская	personal_assistant.scenarios.find_poi	1
заломова	personal_assistant.scenarios.find_poi	1
новый арбат новый арбат	personal_assistant.scenarios.find_poi	1
проспект салават юлаева двадцать четыре	personal_assistant.scenarios.find_poi	1
южная автостанция	personal_assistant.scenarios.find_poi	1
первый курьяновский двадцать четыре дробь два	personal_assistant.scenarios.find_poi	1
поворот на толстопальцево	personal_assistant.scenarios.find_poi	1
метро саларьево	personal_assistant.scenarios.find_poi	1
деревня комарово где находится	personal_assistant.scenarios.find_poi	1
ночные клубы	personal_assistant.scenarios.find_poi	1
татнефть	personal_assistant.scenarios.find_poi	1
тиз ватутинки	personal_assistant.scenarios.find_poi	1
фаст	personal_assistant.scenarios.find_poi	1
лондон молл на дальневосточном проспекте	personal_assistant.scenarios.find_poi	1
нагатинская набережная	personal_assistant.scenarios.find_poi	1
резервный проезд дом восемь дробь два	personal_assistant.scenarios.find_poi	1
смотрим пассаж	personal_assistant.scenarios.find_poi	1
то сервис 24 часа	personal_assistant.scenarios.find_poi	1
индустриальный парк южные ворота фирма джон дир	personal_assistant.scenarios.find_poi	1
нижняя сыромятническая	personal_assistant.scenarios.find_poi	1
федора черенкова спартак москва	personal_assistant.scenarios.find_poi	1
вилиса лациса	personal_assistant.scenarios.find_poi	1
севастополь	personal_assistant.scenarios.find_poi	1
раменский район микрорайон гостевка	personal_assistant.scenarios.find_poi	1
нижняя сыромять	personal_assistant.scenarios.find_poi	1
винил вино	personal_assistant.scenarios.find_poi	1
торговый центр фестиваль	personal_assistant.scenarios.find_poi	1
продукты двадцать четыре	personal_assistant.scenarios.find_poi	1
жк морская звезда	personal_assistant.scenarios.find_poi	1
улица правды дом двадцать шесть	personal_assistant.scenarios.find_poi	1
москва центр города китай город	personal_assistant.scenarios.find_poi	1
волжский прайд	personal_assistant.scenarios.find_poi	1
город батайск храм святой троицы	personal_assistant.scenarios.find_poi	1
лермонтов гибдд	personal_assistant.scenarios.find_poi	1
зельгрос бирюлево	personal_assistant.scenarios.find_poi	1
город тюмень	personal_assistant.scenarios.find_poi	1
восьмой новоподмосковный проезд	personal_assistant.scenarios.find_poi	1
лесобаза	personal_assistant.scenarios.find_poi	1
котлас промышленный тупик 5	personal_assistant.scenarios.find_poi	1
остаповский проезд двадцать четыре	personal_assistant.scenarios.find_poi	1
город прага чешская республика	personal_assistant.scenarios.find_poi	1
косыгина	personal_assistant.scenarios.find_poi	1
улица шировская поворот игрушки	personal_assistant.scenarios.find_poi	1
мегамаг на левом берегу дона	personal_assistant.scenarios.find_poi	1
станция химки	personal_assistant.scenarios.find_poi	1
улица вести введенщина я аллея 12	personal_assistant.scenarios.find_poi	1
новая эра сормовский поворот	personal_assistant.scenarios.find_poi	1
тойота лосиный остров	personal_assistant.scenarios.find_poi	1
улица доблести дом семь корпус	personal_assistant.scenarios.find_poi	1
икея дыбенко	personal_assistant.scenarios.find_poi	1
энерго снаб комплект	personal_assistant.scenarios.find_poi	1
ближайший фонбет	personal_assistant.scenarios.find_poi	1
брестская	personal_assistant.scenarios.find_poi	1
мкб платежный терминал	personal_assistant.scenarios.find_poi	1
ленинский район	personal_assistant.scenarios.find_poi	1
гудвин	personal_assistant.scenarios.find_poi	1
ленком	personal_assistant.scenarios.find_poi	1
вилдберис	personal_assistant.scenarios.find_poi	1
метро войковская	personal_assistant.scenarios.find_poi	1
торговый комплекс фестиваль	personal_assistant.scenarios.find_poi	1
беладжо	personal_assistant.scenarios.find_poi	1
новая манчарово	personal_assistant.scenarios.find_poi	1
летная парковка	personal_assistant.scenarios.find_poi	1
детский сад теремок управление делами президента	personal_assistant.scenarios.find_poi	1
прогимназия	personal_assistant.scenarios.find_poi	1
белевский район снт мисайлово	personal_assistant.scenarios.find_poi	1
лукойл	personal_assistant.scenarios.find_poi	1
веселая дом четыре	personal_assistant.scenarios.find_poi	1
станция метро серпуховская	personal_assistant.scenarios.find_poi	1
лерикский десять	personal_assistant.scenarios.find_poi	1
kfc по дороге	personal_assistant.scenarios.find_poi	1
рынок царицыно	personal_assistant.scenarios.find_poi	1
продольная сто три	personal_assistant.scenarios.find_poi	1
смотри	personal_assistant.scenarios.find_poi	1
саратовская область контрольно пропускной пункт таскала	personal_assistant.scenarios.find_poi	1
казань компрессор маш	personal_assistant.scenarios.find_poi	1
жк ботанический сад лайф	personal_assistant.scenarios.find_poi	1
подстанция 110	personal_assistant.scenarios.find_poi	1
банкомат 24 часа	personal_assistant.scenarios.find_poi	1
может здесь самарская набережная	personal_assistant.scenarios.find_poi	1
акб	personal_assistant.scenarios.find_poi	1
кристалл	personal_assistant.scenarios.find_poi	1
мегаторг владимир	personal_assistant.scenarios.find_poi	1
снт полимер	personal_assistant.scenarios.find_poi	1
сакрополь	personal_assistant.scenarios.find_poi	1
звенцово	personal_assistant.scenarios.find_poi	1
восемьдесят четвертый километр минского шоссе	personal_assistant.scenarios.find_poi	1
управление внутренних дел	personal_assistant.scenarios.find_poi	1
широкая улица дом двенадцать	personal_assistant.scenarios.find_poi	1
урочище порзолово болото	personal_assistant.scenarios.find_poi	1
казахстан лисаковск	personal_assistant.scenarios.find_poi	1
бишкек где находится	personal_assistant.scenarios.find_poi	1
московская область город химки	personal_assistant.scenarios.find_poi	1
хорошая кофе	personal_assistant.scenarios.find_poi	1
коттеджный поселок московка	personal_assistant.scenarios.find_poi	1
pleer точка ру где находится	personal_assistant.scenarios.find_poi	1
бурлук	personal_assistant.scenarios.find_poi	1
тверь	personal_assistant.scenarios.find_poi	1
деменки кп антонова	personal_assistant.scenarios.find_poi	1
город московский	personal_assistant.scenarios.find_poi	1
город кировск улица набережная дом тридцать семь	personal_assistant.scenarios.find_poi	1
город одинцово 1 по	personal_assistant.scenarios.find_poi	1
метро домодедовская торговый центр или район	personal_assistant.scenarios.find_poi	1
квартал спутник на пруду	personal_assistant.scenarios.find_poi	1
лежена 6 / 2	personal_assistant.scenarios.find_poi	1
теремок глобал сити там есть	personal_assistant.scenarios.find_poi	1
тускла метро токийского	personal_assistant.scenarios.find_poi	1
вадковский переулок	personal_assistant.scenarios.find_poi	1
ляпидевского	personal_assistant.scenarios.find_poi	1
яндекс где находится	personal_assistant.scenarios.find_poi	1
офис такси на литвина седого	personal_assistant.scenarios.find_poi	1
официальный диллер митсубиси	personal_assistant.scenarios.find_poi	1
71 гкб	personal_assistant.scenarios.find_poi	1
курьяновская	personal_assistant.scenarios.find_poi	1
марина клаб	personal_assistant.scenarios.find_poi	1
часцы 4	personal_assistant.scenarios.find_poi	1
сибирский поворот алтайский край	personal_assistant.scenarios.find_poi	1
якова апостольский переулок	personal_assistant.scenarios.find_poi	1
экострой	personal_assistant.scenarios.find_poi	1
виноградова один	personal_assistant.scenarios.find_poi	1
афина express nails	personal_assistant.scenarios.find_poi	1
красносело	personal_assistant.scenarios.find_poi	1
артплей	personal_assistant.scenarios.find_poi	1
авто азарт на правом берегу	personal_assistant.scenarios.find_poi	1
переулок берников два	personal_assistant.scenarios.find_poi	1
кировский район где находится	personal_assistant.scenarios.find_poi	1
щелково кемп	personal_assistant.scenarios.find_poi	1
береговой проезд киа моторс	personal_assistant.scenarios.find_poi	1
любонь	personal_assistant.scenarios.find_poi	1
город новосибирск	personal_assistant.scenarios.find_poi	1
мои документы раменки	personal_assistant.scenarios.find_poi	1
центр науч фильм	personal_assistant.scenarios.find_poi	1
арт аэропорт внуково	personal_assistant.scenarios.find_poi	1
покажите на карте администрацию города ейска	personal_assistant.scenarios.find_poi	1
инессы арманд 7	personal_assistant.scenarios.find_poi	1
снт полярник 2	personal_assistant.scenarios.find_poi	1
октябрьский двенадцать	personal_assistant.scenarios.find_poi	1
касторама на шоссе нефтяников	personal_assistant.scenarios.find_poi	1
село софьино чонгарский бульвар дом восемнадцать	personal_assistant.scenarios.find_poi	1
мадрид	personal_assistant.scenarios.find_poi	1
хованский вход	personal_assistant.scenarios.find_poi	1
город грозный ртс	personal_assistant.scenarios.find_poi	1
большой дровяной восемь	personal_assistant.scenarios.find_poi	1
форест микс	personal_assistant.scenarios.find_poi	1
интерфуд на комсомольск на толе би	personal_assistant.scenarios.find_poi	1
пункт обогрева ночлежка	personal_assistant.scenarios.find_poi	1
тополь как поехать	personal_assistant.scenarios.find_poi	1
абжалилова	personal_assistant.scenarios.find_poi	1
жан жак	personal_assistant.scenarios.find_poi	1
царицыно	personal_assistant.scenarios.find_poi	1
нанжуль 47 / 2	personal_assistant.scenarios.find_poi	1
кп стольный	personal_assistant.scenarios.find_poi	1
ривьера	personal_assistant.scenarios.find_poi	1
причал сто три	personal_assistant.scenarios.find_poi	1
норавто	personal_assistant.scenarios.find_poi	1
мэйджор сорок седьмой километр мкад	personal_assistant.scenarios.find_poi	1
автомир	personal_assistant.scenarios.find_poi	1
велозапчасти	personal_assistant.scenarios.find_poi	1
солнечногорск макдоналдс	personal_assistant.scenarios.find_poi	1
окружной дом офицеров	personal_assistant.scenarios.find_poi	1
котельники	personal_assistant.scenarios.find_poi	1
google костромская двадцать	personal_assistant.scenarios.find_poi	1
бела куна пять	personal_assistant.scenarios.find_poi	1
йошкар ола	personal_assistant.scenarios.find_poi	1
автодом вернадского	personal_assistant.scenarios.find_poi	1
вишневского	personal_assistant.scenarios.find_poi	1
фастфуд сорок	personal_assistant.scenarios.find_poi	1
микрорайон фестиваль	personal_assistant.scenarios.find_poi	1
астрахань солянка	personal_assistant.scenarios.find_poi	1
памятник погибшим милиционерам	personal_assistant.scenarios.find_poi	1
свободи 24 / 29	personal_assistant.scenarios.find_poi	1
нефедова нефедова 58 до 115	personal_assistant.scenarios.find_poi	1
станция метро бауманская	personal_assistant.scenarios.find_poi	1
ханой	personal_assistant.scenarios.find_poi	1
каштановая роща	personal_assistant.scenarios.find_poi	1
кокорай 77 / 7	personal_assistant.scenarios.find_poi	1
каратал	personal_assistant.scenarios.find_poi	1
белово вокзал	personal_assistant.scenarios.find_poi	1
домодедово	personal_assistant.scenarios.find_poi	1
мартис ком вольгинский	personal_assistant.scenarios.find_poi	1
роза хутор	personal_assistant.scenarios.find_poi	1
успенская гаи гибдд	personal_assistant.scenarios.find_poi	1
город реутов	personal_assistant.scenarios.find_poi	1
зеленоград	personal_assistant.scenarios.find_poi	1
сивцев вражек	personal_assistant.scenarios.find_poi	1
город москва улица зеленый	personal_assistant.scenarios.find_poi	1
гостиница марко пробок	personal_assistant.scenarios.find_poi	1
метро китай город	personal_assistant.scenarios.find_poi	1
аэровокзал домодедово	personal_assistant.scenarios.find_poi	1
тифлиси	personal_assistant.scenarios.find_poi	1
сауна казачий пробок	personal_assistant.scenarios.find_poi	1
двадцать пятый километр мкада	personal_assistant.scenarios.find_poi	1
новокузнецкая	personal_assistant.scenarios.find_poi	1
город москва	personal_assistant.scenarios.find_poi	1
япоша б	personal_assistant.scenarios.find_poi	1
крекшино лудинг	personal_assistant.scenarios.find_poi	1
площадь европы два	personal_assistant.scenarios.find_poi	1
коммунарка	personal_assistant.scenarios.find_poi	1
метро вднх	personal_assistant.scenarios.find_poi	1
7 батальон дпс	personal_assistant.scenarios.find_poi	1
башня федерации	personal_assistant.scenarios.find_poi	1
самомойка машине помыть	personal_assistant.scenarios.find_poi	1
карельская пятьдесят один	personal_assistant.scenarios.find_poi	1
платформа лось	personal_assistant.scenarios.find_poi	1
варсонофьевский переулок	personal_assistant.scenarios.find_poi	1
метро новочеркасская	personal_assistant.scenarios.find_poi	1
поселок арсланова	personal_assistant.scenarios.find_poi	1
европа сити молл	personal_assistant.scenarios.find_poi	1
воробьевы горы	personal_assistant.scenarios.find_poi	1
победы парк победы	personal_assistant.scenarios.find_poi	1
хутынь	personal_assistant.scenarios.find_poi	1
сочи	personal_assistant.scenarios.find_poi	1
метро каширская	personal_assistant.scenarios.find_poi	1
пост ям ижора тосненский район	personal_assistant.scenarios.find_poi	1
одинцовский район	personal_assistant.scenarios.find_poi	1
станция метро фили	personal_assistant.scenarios.find_poi	1
торговый дом фестиваль	personal_assistant.scenarios.find_poi	1
первомайская	personal_assistant.scenarios.find_poi	1
бизнес парк румянцево	personal_assistant.scenarios.find_poi	1
албанская площадь	personal_assistant.scenarios.find_poi	1
напиши вегас кунцево	personal_assistant.scenarios.find_poi	1
арбеково мечеть	personal_assistant.scenarios.find_poi	1
парнас	personal_assistant.scenarios.find_poi	1
бизнес центр даймонд холл	personal_assistant.scenarios.find_poi	1
московская область	personal_assistant.scenarios.find_poi	1
оджахури	personal_assistant.scenarios.find_poi	1
город видное	personal_assistant.scenarios.find_poi	1
кемпински	personal_assistant.scenarios.find_poi	1
ереван столица армении	personal_assistant.scenarios.find_poi	1
лежена 10 / 2	personal_assistant.scenarios.find_poi	1
экспоцентр	personal_assistant.scenarios.find_poi	1
ростов беломорский страна советов	personal_assistant.scenarios.find_poi	1
льва Толстого 16	personal_assistant.scenarios.find_poi	1
найди заправку рядом	personal_assistant.scenarios.find_poi	1
где тут бассейн	personal_assistant.scenarios.find_poi	1
поехали на Льва Толстого 16	personal_assistant.scenarios.show_route	1
поехали домой	personal_assistant.scenarios.show_route	1
поехали к бабушке	personal_assistant.scenarios.show_route	1
ближайшая заправка	personal_assistant.scenarios.find_poi	1
сколько мне ещё ехать	personal_assistant.navi.how_long_to_drive	1
во сколько я приеду	personal_assistant.navi.when_we_get_there	1
сколько мне ещё стоять	personal_assistant.navi.how_long_traffic_jam	1
обзор маршрута	personal_assistant.navi.show_route_on_map	1
покажи весь маршрут	personal_assistant.navi.show_route_on_map	1
сбрось маршрут	personal_assistant.navi.reset_route	1
включи мне голос Харламова	personal_assistant.navi.change_voice	1
парковки	personal_assistant.navi.show_layer	1
покажи парковки	personal_assistant.navi.show_layer	1
найди парковку	personal_assistant.navi.parking_route	1
впереди авария	personal_assistant.navi.add_point	1
поставь камеру	personal_assistant.navi.add_point	1
напиши разговорчик	personal_assistant.navi.add_point	1
авария в правом ряду    	personal_assistant.navi.add_point	1
авария  	personal_assistant.navi.add_point	1
дтп 	personal_assistant.navi.add_point	1
авария в левом ряду 	personal_assistant.navi.add_point	1
дтп левый ряд   	personal_assistant.navi.add_point	1
алиса, поставь точку авария 	personal_assistant.navi.add_point	1
вижу дтп в правом ряду  	personal_assistant.navi.add_point	1
дтп, тойота и мерседес  	personal_assistant.navi.add_point	1
авария средний ряд  	personal_assistant.navi.add_point	1
вижу авария в правом ряду   	personal_assistant.navi.add_point	1
поставить точку авария  	personal_assistant.navi.add_point	1
вижу аварию 	personal_assistant.navi.add_point	1
стукнулись двое впереди 	personal_assistant.navi.add_point	1
правом ряду авария  	personal_assistant.navi.add_point	1
тут авария  	personal_assistant.navi.add_point	1
впереди дтп 	personal_assistant.navi.add_point	1
машина сломался правом ряду 	personal_assistant.navi.add_point	1
отметь дтп в правом ряду    	personal_assistant.navi.add_point	1
здесь авария на встречный площадь   	personal_assistant.navi.add_point	1
слушай яндекс авария правый ряд 	personal_assistant.navi.add_point	1
дорожные работы 	personal_assistant.navi.add_point	1
впереди ремонт моста    	personal_assistant.navi.add_point	1
все перекопано  	personal_assistant.navi.add_point	1
опять все перекопали    	personal_assistant.navi.add_point	1
впереди ремонт дороги   	personal_assistant.navi.add_point	1
дорожные работы в левом ряду    	personal_assistant.navi.add_point	1
реконструкция дороги    	personal_assistant.navi.add_point	1
поставь точку ремонт    	personal_assistant.navi.add_point	1
установи точку ремонт дороги    	personal_assistant.navi.add_point	1
слушай яндекс ремонт дороги 	personal_assistant.navi.add_point	1
слушай алиса нефть ищут 	personal_assistant.navi.add_point	1
слушай алиса идут раскопки  	personal_assistant.navi.add_point	1
ремонтные работы в правом ряду  	personal_assistant.navi.add_point	1
разрыли дорогу  	personal_assistant.navi.add_point	1
опять все разрыли в правом ряду 	personal_assistant.navi.add_point	1
перекопали 49 километр егорьевского шоссе   	personal_assistant.navi.add_point	1
ремонт дороги в левом ряду  	personal_assistant.navi.add_point	1
золото ищут в среднем ряду  	personal_assistant.navi.add_point	1
левый ряд ремонт    	personal_assistant.navi.add_point	1
зафиксриуй ремонт моста 	personal_assistant.navi.add_point	1
поставь камеру  	personal_assistant.navi.add_point	1
стоят   	personal_assistant.navi.add_point	1
впереди дпс 	personal_assistant.navi.add_point	1
засада ментов   	personal_assistant.navi.add_point	1
гайцы стоят 	personal_assistant.navi.add_point	1
поставь стационарную камеру 	personal_assistant.navi.add_point	1
впереди камера на 60    	personal_assistant.navi.add_point	1
вижу камеру 	personal_assistant.navi.add_point	1
отметь на карте камеру  	personal_assistant.navi.add_point	1
впереди патруль 	personal_assistant.navi.add_point	1
алиса отметь камеру 	personal_assistant.navi.add_point	1
слушай яндекс впереди камера    	personal_assistant.navi.add_point	1
впереди засада  	personal_assistant.navi.add_point	1
вижу экипаж     	personal_assistant.navi.add_point	1
сохрани тут камеру  	personal_assistant.navi.add_point	1
впереди фотографируют   	personal_assistant.navi.add_point	1
зафиксируй, что тут камера  	personal_assistant.navi.add_point	1
впереди радар   	personal_assistant.navi.add_point	1
вижу радар  	personal_assistant.navi.add_point	1
полиция 	personal_assistant.navi.add_point	1
поставь разговорчик 	personal_assistant.navi.add_point	1
зафиксируй разговорчик  	personal_assistant.navi.add_point	1
отметь тут точку разговорчик    	personal_assistant.navi.add_point	1
почему стоит    	personal_assistant.navi.add_point	1
слушай яндекс поставить точку разговорчики  	personal_assistant.navi.add_point	1
поставь разговорчики почему стоит   	personal_assistant.navi.add_point	1
установить точку разговорчики   	personal_assistant.navi.add_point	1
отметь точку текст  	personal_assistant.navi.add_point	1
поставь текст на карту  	personal_assistant.navi.add_point	1
запиши текст на карту   	personal_assistant.navi.add_point	1
поставь тут разговорчик 	personal_assistant.navi.add_point	1
отметь тут текст    	personal_assistant.navi.add_point	1
поставь ошибку  	personal_assistant.navi.add_point	1
поставь точку ошибка    	personal_assistant.navi.add_point	1
запиши ошибку   	personal_assistant.navi.add_point	1
нет поворота    	personal_assistant.navi.add_point	1
нет проезда     	personal_assistant.navi.add_point	1
поворот запрещен    	personal_assistant.navi.add_point	1
ошибка на карте 	personal_assistant.navi.add_point	1
слушай яндекс тут нет поворота  	personal_assistant.navi.add_point	1
поставь ошибка шлагбаум 	personal_assistant.navi.add_point	1
поставь ошибку перекрытие   	personal_assistant.navi.add_point	1
ошибка кирпич такси нельзя  	personal_assistant.navi.add_point	1
ошибка запрет движения  	personal_assistant.navi.add_point	1
слушай яндекс тут ошибка    	personal_assistant.navi.add_point	1
алиса тут ошибка на карте 	personal_assistant.navi.add_point	1
алиса поставь точку другое  	personal_assistant.navi.add_point	1
поставь метку другое    	personal_assistant.navi.add_point	1
давай поставим метку другое 	personal_assistant.navi.add_point	1
яндекс отметь метку другое  	personal_assistant.navi.add_point	1
поставь точку другое    	personal_assistant.navi.add_point	1
поставь другое дорожное событие 	personal_assistant.navi.add_point	1
отметь дорожное событие другое  	personal_assistant.navi.add_point	1
поставь штурмана баста  	personal_assistant.navi.change_voice	1
вруби мне голос басты   	personal_assistant.navi.change_voice	1
хочу голос гарика харламова 	personal_assistant.navi.change_voice	1
какие есть голоса   	personal_assistant.navi.change_voice	1
какие голоса умеет навигатор    	personal_assistant.navi.change_voice	1
вруби оксану    	personal_assistant.navi.change_voice	1
верни мне голос васи    	personal_assistant.navi.change_voice	1
хочу голос из звездных войн 	personal_assistant.navi.change_voice	1
алиса поставь пожалуйста голос басты    	personal_assistant.navi.change_voice	1
включи диктора бондарчука   	personal_assistant.navi.change_voice	1
включи уткина как диктора   	personal_assistant.navi.change_voice	1
скрой пробки    	personal_assistant.navi.hide_layer	1
убери пробки    	personal_assistant.navi.hide_layer	1
скрой пробки на карте   	personal_assistant.navi.hide_layer	1
не хочу пробки на карте 	personal_assistant.navi.hide_layer	1
очисть карту от пробок  	personal_assistant.navi.hide_layer	1
выруби пробки   	personal_assistant.navi.hide_layer	1
удали пробки    	personal_assistant.navi.hide_layer	1
алиса удали с карты пробки  	personal_assistant.navi.hide_layer	1
не нужно пробок на карте    	personal_assistant.navi.hide_layer	1
слушай яндекс не надо пробок на карте   	personal_assistant.navi.hide_layer	1
скрой парковки  	personal_assistant.navi.hide_layer	1
убери парковки  	personal_assistant.navi.hide_layer	1
скрой парковки на карте 	personal_assistant.navi.hide_layer	1
не хочу парковки на карте   	personal_assistant.navi.hide_layer	1
очисть карту от парковок    	personal_assistant.navi.hide_layer	1
выруби парковки 	personal_assistant.navi.hide_layer	1
удали парковки  	personal_assistant.navi.hide_layer	1
алиса удали с карты парковки    	personal_assistant.navi.hide_layer	1
не нужно парковок на карте  	personal_assistant.navi.hide_layer	1
слушай яндекс не надо парковок на карте 	personal_assistant.navi.hide_layer	1
покажи парковки 	personal_assistant.navi.show_layer	1
отобрази парковки   	personal_assistant.navi.show_layer	1
где парковки на карте   	personal_assistant.navi.show_layer	1
вруби парковки на карте 	personal_assistant.navi.show_layer	1
верни парковки на карту 	personal_assistant.navi.show_layer	1
покажи мне все парковки 	personal_assistant.navi.show_layer	1
хочу увидеть парковки   	personal_assistant.navi.show_layer	1
парковки на карте   	personal_assistant.navi.show_layer	1
где тут есть парковки   	personal_assistant.navi.parking_route	1
слушай алиса парковки покажи    	personal_assistant.navi.show_layer	1
покажи пробки   	personal_assistant.navi.show_layer	1
отобрази пробки 	personal_assistant.navi.show_layer	1
где пробки на карте 	personal_assistant.navi.show_layer	1
вруби пробки на карте   	personal_assistant.navi.show_layer	1
верни пробки на карту   	personal_assistant.navi.show_layer	1
покажи мне все пробки   	personal_assistant.navi.show_layer	1
какие тут пробки    	personal_assistant.scenarios.show_traffic	1
хочу увидеть пробки 	personal_assistant.navi.show_layer	1
пробки на карте 	personal_assistant.navi.show_layer	1
где тут есть пробки 	personal_assistant.navi.show_layer	1
слушай алиса пробки покажи 	personal_assistant.navi.show_layer	1
покажи мне спутник  	personal_assistant.navi.show_layer	1
алиса спутниковые снимки    	personal_assistant.navi.show_layer	1
алиса включи спутинк    	personal_assistant.navi.show_layer	1
слушай яндекс хочу спутник  	personal_assistant.navi.show_layer	1
спутниковая карта   	personal_assistant.navi.show_layer	1
переключи карту на спутник  	personal_assistant.navi.show_layer	1
дай спутниковую карту   	personal_assistant.navi.show_layer	1
покажи мне спутниковую карту    	personal_assistant.navi.show_layer	1
переключи на спутник  	personal_assistant.navi.show_layer	1
верни карту 	personal_assistant.navi.show_layer	1
верни схему 	personal_assistant.navi.show_layer	1
выключи спутник 	personal_assistant.navi.hide_layer	1
алиса не хочу больше спутник    	personal_assistant.navi.hide_layer	1
убери спутник   	personal_assistant.navi.hide_layer	1
переключи обратно на схему  	personal_assistant.navi.show_layer	1
выключи спутниковую карту   	personal_assistant.navi.hide_layer	1
больше не хочу спутниковую карту    	personal_assistant.navi.hide_layer	1
включи карту схему  	personal_assistant.navi.show_layer	1
алиса выключи звуки 	personal_assistant.scenarios.sound_mute	1
выключи звук навигатора 	personal_assistant.scenarios.sound_mute	1
алиса не слышать диктора    	personal_assistant.scenarios.sound_mute	1
включи без звука    	personal_assistant.scenarios.sound_mute	1
включи беззвучный режим 	personal_assistant.scenarios.sound_mute	1
выключи все звуки   	personal_assistant.scenarios.sound_mute	1
выключи звук    	personal_assistant.scenarios.sound_mute	1
выключи диктора 	personal_assistant.scenarios.sound_mute	1
выключи голосовое сопровождение 	personal_assistant.scenarios.sound_mute	1
не хочу голосовое сопровождение 	personal_assistant.scenarios.sound_mute	1
алиса выключи голоса  	personal_assistant.scenarios.sound_mute	1
верник звуки    	personal_assistant.scenarios.other	1
алиса верни обратно звук    	personal_assistant.scenarios.sound_unmute	1
выключи беззвучный режим    	personal_assistant.scenarios.sound_unmute	1
алиса верни диктора 	personal_assistant.scenarios.sound_unmute	1
включи все звуки    	personal_assistant.scenarios.sound_unmute	1
закончить беззвучный режим  	personal_assistant.scenarios.sound_unmute	1
хочу снова слышать звуки навигатора 	personal_assistant.scenarios.sound_unmute	1
включи звук в навигаторе    	personal_assistant.scenarios.sound_unmute	1
включи обратно звук 	personal_assistant.scenarios.sound_unmute	1
вруби звук  	personal_assistant.scenarios.sound_unmute	1
сколько мне еще ехать   	personal_assistant.navi.how_long_to_drive	1
сколько осталось    	personal_assistant.navi.how_long_to_drive	1
сколько до конца маршрута   	personal_assistant.navi.how_long_to_drive	1
сколько осталось маршрута   	personal_assistant.navi.how_long_to_drive	1
сколько километров до финиша    	personal_assistant.navi.how_long_to_drive	1
сколько до финиша   	personal_assistant.navi.how_long_to_drive	1
когда приеду    	personal_assistant.navi.when_we_get_there	1
сколько еще км  	personal_assistant.navi.how_long_to_drive	1
когда я доеду   	personal_assistant.navi.when_we_get_there	1
долго еще   	personal_assistant.navi.how_long_to_drive	1
далеко еще  	personal_assistant.navi.how_long_to_drive	1
во сколько прибытие 	personal_assistant.navi.when_we_get_there	1
когда доедем    	personal_assistant.navi.when_we_get_there	1
во сколько приеду   	personal_assistant.navi.when_we_get_there	1
во сколько буду 	personal_assistant.navi.when_we_get_there	1
во сколько приедем  	personal_assistant.navi.when_we_get_there	1
в каком часу буду   	personal_assistant.navi.when_we_get_there	1
точное время прибытия   	personal_assistant.navi.when_we_get_there	1
алиса скажи во сколько приедем  	personal_assistant.navi.when_we_get_there	1
слушай яндекс время прибытия    	personal_assistant.navi.when_we_get_there	1
время прибытия по москве    	personal_assistant.navi.when_we_get_there	1
во сколько точно приедем  	personal_assistant.navi.when_we_get_there	1
на долго пробка 	personal_assistant.navi.how_long_traffic_jam	1
сколько еще стоять будем    	personal_assistant.navi.how_long_traffic_jam	1
долго стоять    	personal_assistant.navi.how_long_traffic_jam	1
сколько простоим    	personal_assistant.navi.how_long_traffic_jam	1
большая ли пробка   	personal_assistant.navi.how_long_traffic_jam	1
сколько стоять  	personal_assistant.navi.how_long_traffic_jam	1
на долго тут    	personal_assistant.navi.how_long_traffic_jam	1
на долго встряли    	personal_assistant.navi.how_long_traffic_jam	1
долго простоим  	personal_assistant.navi.how_long_traffic_jam	1
когда уже поедем    	personal_assistant.navi.how_long_traffic_jam	1
на долго красное    	personal_assistant.navi.how_long_traffic_jam	1
сколько до зеленого 	personal_assistant.navi.how_long_traffic_jam	1
я тут на долго  	personal_assistant.navi.how_long_traffic_jam	1
обзор маршрута  	personal_assistant.navi.show_route_on_map	1
покажи маршрут  	personal_assistant.navi.show_route_on_map	1
покажи дорогу   	personal_assistant.navi.show_route_on_map	1
покажи путь 	personal_assistant.navi.show_route_on_map	1
как едем    	personal_assistant.navi.show_route_on_map	1
показать весь маршрут   	personal_assistant.navi.show_route_on_map	1
обзор карта 	personal_assistant.navi.show_route_on_map	1
покажи весь маршрут движения    	personal_assistant.navi.show_route_on_map	1
маршрут целиком 	personal_assistant.navi.show_route_on_map	1
весь маршрут    	personal_assistant.navi.show_route_on_map	1
давай маршрут с высоты  	personal_assistant.navi.show_route_on_map	1
полный маршрут  	personal_assistant.navi.show_route_on_map	1
сбрось маршрут  	personal_assistant.navi.reset_route	1
отмени маршрут  	personal_assistant.navi.reset_route	1
отменить маршрут    	personal_assistant.navi.reset_route	1
сбросить маршрут    	personal_assistant.navi.reset_route	1
отмена маршрута 	personal_assistant.navi.reset_route	1
закрыть маршрут 	personal_assistant.navi.reset_route	1
удалить маршрут 	personal_assistant.navi.reset_route	1
остановить маршрут  	personal_assistant.navi.reset_route	1
отменить текущий маршрут    	personal_assistant.navi.reset_route	1
прекратить ведение маршрута 	personal_assistant.navi.reset_route	1
сбрось ведение маршрута 	personal_assistant.navi.reset_route	1
найди парковку  	personal_assistant.navi.parking_route	1
ищи парковку    	personal_assistant.navi.parking_route	1
поиск парковок  	personal_assistant.navi.parking_route	1
где припарковаться  	personal_assistant.navi.parking_route	1
парковочный маршрут 	personal_assistant.navi.parking_route	1
маршрут до парковки 	personal_assistant.navi.parking_route	1
давай поищем парковку   	personal_assistant.navi.parking_route	1
где бросить машину  	personal_assistant.navi.parking_route	1
где оставить тачку 	personal_assistant.navi.parking_route	1
