Безработица в России	является довольно высокой ещё с советских времён, когда рождаемость снизилась, а число женщин, вовлечённых в экономику, резко возросло.	еще
250 лучших фильмов по версии IMDb	список лучших художественных фильмов мира, который формируется на основе оценок, выставляемых картинам зарегистрированными посетителями сайта IMDb.	imdb
БДСМ	психосексуальная субкультура, основанная на эротическом обмене властью и иных формах сексуальных отношений, затрагивающих ролевые игры в господство и подчинение.	психосексуальная
Alt-код	код, символы которого вызываются посредством кнопки Alt и цифры на NUM-PAD'е.	NUM-PAD'е
Русский алфавит	алфавит русского языка, в нынешнем виде с 33 буквами существующий фактически с 1918 года.	33 буквами
Рабочее место	это неделимое в организационном отношении звено производственного процесса, обслуживаемое одним или несколькими рабочими, предназначенное для выполнения одной или нескольких производственных или обслуживающих операций, оснащённое соответствующим оборудованием и технологической оснасткой.	в организационном prep
Ключевая ставка	процентная ставка, по которой Центральный банк России предоставляет кредиты коммерческим банкам в долг на одну неделю, и одновременно та ставка, по которой ЦБ РФ готов принимать от банков на депозиты денежные средства.	по которой, на депозиты prep
Валовой внутренний продукт	макроэкономический показатель, отражающий рыночную стоимость всех конечных товаров и услуг, произведённых за год во всех отраслях экономики на территории государства для потребления, экспорта и накопления, вне зависимости от национальной принадлежности использованных факторов производства.	 за год prep
Люстрация	в посткоммунистических государствах Восточной и Центральной Европы законодательные меры и практика недопущения в государственную службу, аппарат государственного управления, правоохранительные органы, на иные важные посты и в учреждения системы образования лиц, которые неугодны правящим кругам по политическим мотивам, лиц, связанных с репрессивным аппаратом прежних режимов, - функционеров коммунистических партий, сотрудников и агентов органов госбезопасности.	по политическим prep
Нефть	природная маслянистая горючая жидкость со специфическим запахом, состоящая в основном из сложной смеси углеводородов различной молекулярной массы и некоторых других химических соединений.	со специфическим, в основном prep
Тунеядство	в нетерминологическом значении «лень, безделье», «жизнь за счёт чужого труда, на чужой счёт», «паразитическое существование за счёт общества».	за счет, на чужой
Крещение Руси	введение в Древней Руси христианства как государственной религии, осуществлённое в конце X века князем Владимиром Святославичем.	введение
Население России	состав жителей, населяющих территорию России.
Вики	веб-сайт, структуру и содержимое которого пользователи могут самостоятельно изменять с помощью инструментов, предоставляемых самим сайтом.	веб сайт
Инфляция	повышение уровня цен на товары и услуги.	инфляция
Население Земли	непрерывно возобновляющаяся, в процессе воспроизводства, совокупность людей, живущих на Земле в целом.	на земле prep
Философия	особая форма познания мира, вырабатывающая систему знаний о наиболее общих характеристиках, предельно-обобщающих понятиях и фундаментальных принципах реальности и познания, бытия человека, об отношении человека и мира.	об отношении prep
Метафора	слово или выражение, употребляемое в переносном значении, в основе которого лежит неназванное сравнение предмета с каким-либо другим на основании их общего признака.	в основе prep и оглушение, на основании
Государство	это властно-политическая организация, обладающая суверенитетом, специальным аппаратом управления и принуждения, а также устанавливающая правовой порядок на определённой территории.	на определенной prep
Орден Феникса	была написана английской писательницей Дж. К. Роулинг с 1997 по 2007 год.	инициалы
Порнография	отображение сексуального поведения в литературе, изображениях, скульптурах, фильмах и др. с целью вызвать сексуальное возбуждение.	norm и др.
Родство	отношения между индивидами, основанные на происхождении от общего предка или возникшие в результате заключения брака, организующие социальные группы и роли.	на происхождении prep
Экономика России	пятая экономика среди стран мира по объёму ВВП по ППС.	по ППС prep
Армата	тяжёлая гусеничная платформа, разработанная Уралвагонзаводом.	уралвагонзаводом
Законы Ньютона	три закона, лежащие в основе классической механики и позволяющие записать уравнения движения для любой механической системы, если известны силовые взаимодействия для составляющих её тел.	в основе prep
Маргинал	человек, находящийся на границе различных социальных групп, систем, культур и испытывающий влияние их противоречащих друг другу норм, ценностей, и т. д.	на границе prep
14/88	кодовый лозунг у белых националистов.	norm slash
Экзистенциализм	особое направление в философии XX века, акцентирующее своё внимание на уникальности бытия человека, провозглашающее его иррациональным.	на уникальности prep
Десять заповедей	предписания, десять основных законов, которые, согласно Пятикнижию, были даны Моисею самим Богом, в присутствии сынов Израиля, на горе Синай на пятидесятый день после Исхода из Египта.	из Египта
Размер мужского полового члена	характеристика мужского полового члена по длине и ширине.	по длине prep
2015	Год культуры России в Аргентине и Аргентины в России.	norm prep 2015, в Аргентине
Фистинг	сексуальная практика, которая подразумевает введение нескольких пальцев или кулака одной или нескольких рук в вагину или анус.	введение
Белки	высокомолекулярные органические вещества, состоящие из альфа-аминокислот, соединённых в цепочку пептидной связью.	белки
Латинский алфавит	восходящая к греческому алфавиту буквенная письменность, возникшая в латинском языке в середине I тысячелетия до н. э. и впоследствии распространившаяся по всему миру.		н.э. norm
Петтинг	форма сексуальной активности, предполагающая получение удовлетворения партнёров путём возбуждения эрогенных зон без непосредственного контакта гениталий.	гениталий
Религия	особая форма осознания мира, обусловленная верой в сверхъестественное, включающая в себя свод моральных норм и типов поведения, обрядов, культовых действий и объединение людей в организации.	сверхъестественное, в организации	prep
A4	формат бумаги, определённый стандартом ISO 216, основан на метрической системе мер.	а4
Список стран по ВВП	то есть стоимостью всех конечных товаров и услуг, реализованных в национальной экономике за один год.	то есть
Менеджмент	разработка и создание, максимально-эффективное использование и контроль социально-экономических систем.	менеджмент
Аутсорсинг	передача организацией, на основании договора, определённых бизнес-процессов или производственных функций на обслуживание другой компании, специализирующейся в соответствующей области.	на обслуживание prep
Рецессия	в экономике термин обозначает относительно умеренный, некритический спад производства или замедление темпов экономического роста.	prep
Вода	бинарное неорганическое соединение с химической формулой Н₂O. Молекула воды состоит из двух атомов водорода и одного - кислорода, которые соединены между собой ковалентной связью.	chem
Доллар США	денежная единица США, одна из основных резервных валют мира.	из основных prep
Оскар	ежегодная кинопремия, традиционно вручающаяся в Лос-Анджелесе.	Лос-Анджелесе
Интроверсия - экстраверсия	распространённый в психологии критерий категоризации или показатель измерения черт личности.	критерий
Логарифм	определяется как показатель степени, в которую надо возвести основание a, чтобы получить число, чтобы получить число , чтобы получить число, чтобы получить число b..		math
Гектар	внесистемная единица измерения площади, равная площади квадрата со стороной 100 м: 1 га = 10 000 м² = 100 а = 100 соток = 0,01 км².	norm
Таблица математических символов	знаки, которые символизируют определённые математические действия со своими аргументами.	со своими prep
Список телефонных кодов стран	определены рекомендациями ITU-T под номерами E.123 и E.164.
Франшиза	страница значений	франшиза
Пятая колонна	наименование агентуры генерала Франко, действовавшей в Испанской Республике во время Гражданской войны в Испании 1936-1939 гг.	norm
2С7	советская 203-мм самоходная пушка артиллерии резерва Верховного Главнокомандования.	norm
Фрилансер	частный специалист.	фрилансер
Викинги	раннесредневековые скандинавские мореходы, в VIII-XI веках совершавшие морские походы от Винланда до Биармии и от Каспия до Северной Африки.	norm
Каминг-аут	процесс открытого и добровольного признания человеком своей принадлежности к сексуальному или гендерному меньшинству, либо результат такого процесса.	каминг-аут
Этанол	одноатомный спирт с формулой C₂H₅OH, другой вариант: CH₃-CH₂-OH, второй представитель гомологического ряда одноатомных спиртов, при стандартных условиях летучая, горючая, бесцветная прозрачная жидкость.	norm
Warhammer 40,000	настольная игра-варгейм, разработанная и издаваемая британской компанией Games Workshop, действие которой происходят в мрачной технофэнтезийной вымышленной вселенной.	Workshop
Wi-Fi	торговая марка Wi-Fi Alliance для беспроводных сетей на базе стандарта IEEE 802.11.	IEEE
Логистика	наука, предмет которой заключается в организации рационального процесса продвижения товаров и услуг от поставщиков сырья к потребителям, функционирования сферы обращения продукции, товаров, услуг, управления товарными запасами и провиантом, создания инфраструктуры товародвижения.	в организации prep
Личность	понятие, выработанное для отображения социальной природы человека, рассмотрения его как субъекта социокультурной жизни, определения его как носителя индивидуального начала, самораскрывающегося в контексте социальных отношений, общения и предметной деятельности.	социокультурной
Инкотермс	международные правила в формате словаря, обеспечивающие однозначные толкования наиболее широко используемых торговых терминов в области внешней торговли, прежде всего, относительно франко - места перехода ответственности от продавца к покупателю.	инкотермс, франко, терминов
100 лучших книг всех времён	Норвежского книжного клуба - список из ста книг, составленный в 2002 году Норвежским книжным клубом совместно с Норвежским институтом имени Нобеля.	норвежского, норвежским, нобеля
Классицизм	художественный стиль и эстетическое направление в европейской культуре XVII-XIX вв.	norm
Сетевая модель OSI	сетевая модель стека сетевых протоколов OSI/ISO.	norm
Априори	знание, полученное до опыта и независимо от него, т.е. знание, как бы заранее известное.	знание
Сибирский хаски	порода собак, заводская специализированная порода, зарегистрированная американскими кинологами в 30-х годах XX века как ездовая собака и полученная от аборигенных собак с Дальнего Востока, в основном с Анадыря, Колымы, Камчатки, принадлежавших местным оседлым приморским племенам - юкагирам, керекам, азиатским эскимосам и приморским чукчам - собаководам - анкальын, которых некоторые далекие от этнографической науки авторы по ошибке принимают за чукчей-оленеводов.	кинологами, в основном prep
Свастика	крест с загнутыми под прямым углом концами.	под прямым prep
Электрический конденсатор	двухполюсник с определённым или переменным значением ёмкости и малой проводимостью; устройство для накопления заряда и энергии электрического поля.		с определенным prep конденсатор
Овуляция	явление, представляющее собой выход яйцеклетки из яичника в брюшную полость в результате разрыва зрелого фолликула.	из яичника
Шовинизм	идеология, суть которой заключается в проповеди национального превосходства с целью обоснования права на дискриминацию и угнетение других народов.	на дискриминацию prep
Т-34	советский средний танк периода Великой Отечественной войны, выпускался серийно с 1940 года, был основным танком РККА до первой половины 1944 годa, когда на смену ему пришёл танк модификации Т-34-85.	Т-34-85. norm
Синонимы	как правило, слова, принадлежащие к одной и той же части речи, различные по звучанию и написанию, но имеющие похожее лексическое значение.	по звучанию prep словА
Пирамида потребностей по Маслоу	общеупотребительное название иерархической модели потребностей человека, представляющей собой упрощенное изложение идей американского психолога А. Маслоу.	инициалы
Золотое сечение	соотношение двух величин a и b, b a, когда справедливо b/a = /b.	math	буквы
12-часовой формат времени	12-часовой формат исчисления времени предполагает разбиение 24 часов, составляющих сутки, на два 12-часовых интервала, обозначаемых a.m. и p.m.		norm
Натуральное число	числа, возникающие естественным образом при счёте.	числА
Роман	литературный жанр, как правило, прозаический, который предполагает развернутое повествование о жизни и развитии личности главного героя в кризисный, нестандартный период его жизни.	жизни
Жидкокристаллический дисплей	плоский дисплей на основе жидких кристаллов, а также устройство на основе такого дисплея.	дисплей
Национал-социализм	форма общественного устройства, соединяющая социализм с крайним национализмом и расизмом, а также название идеологии, обосновывающей такого рода социальный порядок.	национализмом
Евро	официальная валюта 19 стран «еврозоны».	norm
нормативно-правовой акт	официальный документ установленной формы, принятый в пределах компетенции уполномоченного государственного органа, иных социальных структур или путём референдума с соблюдением установленной законодательством процедуры, содержащий общеобязательные правила поведения, рассчитанные на неопределённый круг лиц и неоднократное применение.	компетенции рассчитанные
Казаки	представители казачества, сложной социальной культуры, сформировавшейся из военно-служивого сословия, а также «людей гулящих».	казаки
Электронная почта	технология и предоставляемые ею услуги по пересылке и получению электронных сообщений по распределённой компьютерной сети.	по пересылке, по распределенной сети prep
LTE	стандарт беспроводной высокоскоростной передачи данных для мобильных телефонов и других терминалов, работающих с данными.	терминалов
Момент инерции	скалярная физическая величина, мера инертности во вращательном движении вокруг оси, подобно тому, как масса тела является мерой его инертности в поступательном движении.	вокруг оси
Звуковые сигналы BIOS	Во время начальной загрузки компьютера при помощи программ, записанных в BIOS, происходит самотестирование POST.	BIOS POST самотестирование
Волатильность	статистический финансовый показатель, характеризующий изменчивость цены.	цены
Тоталитаризм	политический режим, имеющий полный контроль государства над всеми аспектами жизни общества и человека.	жизни
SWOT-анализ	метод стратегического планирования, заключающийся в выявлении факторов внутренней и внешней среды организации и разделении их на четыре категории: Strengths, Weaknesses, Opportunities и Threats. SWOT-анализ	
Грин-карта	удостоверение личности или так называемая идентификационная карта, подтверждающая наличие вида на жительство у человека, не являющегося гражданином США, но постоянно проживающего на территории США, и предоставляющая право трудоустройства на территории этой страны.	на территории prep
Гомосексуальность	предпочтение представителей своего пола в качестве объекта любовных отношений, эротического влечения и/или сексуального партнёра.	norm и/или
Тунис	государство в Северной Африке. Население, по итогам переписи 2010 года, составляет более 10 миллионов человек, территория - 163 610 км².	по итогам prep
Опцион	договор, по которому покупатель опциона получает право, но не обязательство, совершить покупку или продажу данного актива по заранее оговорённой цене в определённый договором момент в будущем или на протяжении определённого отрезка времени.	по которому, по заранее, в определенный, на протяжении prep
Имя прилагательное	самостоятельная часть речи, обозначающая непроцессуальный признак предмета и отвечающая на вопросы «какой», «какая», «какое», «какие», «чей» и т.д.		prep на вопросы
Нобелевская премия	одна из наиболее престижных международных премий, ежегодно присуждаемая за выдающиеся научные исследования, революционные изобретения или крупный вклад в культуру или развитие общества.	prep за выдающиеся
Сайт	система электронных документов частного лица или организации в компьютерной сети под общим адресом.	лица, сети
Динозавры	надотряд наземных позвоночных животных, доминировавших на Земле в мезозойскую эру - в течение более 160 миллионов лет, начиная с позднего триасового периода до конца мелового периода, когда большинство из них стало вымирать на стыке мелового и третичного периодов во время крупномасштабного исчезновения животных и многих разновидностей растений в относительно короткий геологический период истории.	на земле, до конца, периодов
Список стран по внешнему долгу	определяется как сумма государственного и частного долга к погашению нерезидентам в иностранной валюте, товарами или услугами.	нерезидентам
Ethernet	семейство технологий пакетной передачи данных для компьютерных сетей.	Ethernet
Закон Мёрфи шутливый философский принцип, который формулируется следующим образом: если есть вероятность того, что какая-нибудь неприятность может случиться, то она обязательно произойдёт. то
HTTP	протокол прикладного уровня передачи данных.	HTTP
Консалтинг	деятельность по консультированию руководителей, управленцев по широкому кругу вопросов в сфере финансовой, коммерческой, юридической, технологической, технической, экспертной деятельности.	по консультированию, по широкому prep
Барокко	характеристика европейской культуры XVII-XVIII веков, в эпоху Позднего Возрождения, центром которой была Италия.	norm
B2B	термин, определяющий вид информационного и экономического взаимодействия, классифицированного по типу взаимодействующих субъектов, в данном случае это - юридические лица, которые работают не на конечного рядового потребителя, а на такие же компании, то есть на другой бизнес.	norm на такие prep
Индекс человеческого развития	интегральный показатель, рассчитываемый ежегодно для межстранового сравнения и измерения уровня жизни, грамотности, образованности и долголетия как основных характеристик человеческого потенциала исследуемой территории.	рассчитываемый потенциала
Реформы Петра I	преобразования в государственной и общественной жизни, осуществлённые в период правления в России Петра I.	жизни
Список серий Fairy Tail	не меняйте имена персонажей без причины, в основном все имена написаны правильно!	в основном
IP-адрес	уникальный сетевой адрес узла в компьютерной сети, построенной по протоколу IP.	сети
Квадратное уравнение	алгебраическое уравнение общего вида : ax^2 + bx + c = 0, где где где где x - свободная переменная, - свободная переменная, - свободная переменная, - свободная переменная, a, , b, , c - коэффициенты, причём - коэффициенты, причём - коэффициенты, причём - коэффициенты, причём \quad a \ne 0.	math
Украинский алфавит	не используются Ёё, Ъъ, Ыы, Ээ, но присутствуют Ґґ, Єє, Іі и Її.
Ликвидность	экономический термин, обозначающий способность активов быть быстро проданными по цене, близкой к рыночной.	по цене prep
Баррель	единица измерения объёма нефти, равная 42 галлонам или 158,988 литрам.	norm
Википедия:Избранные статьи	анализ порядковых данных	norm
Фьючерс	производный финансовый инструмент, стандартный срочный биржевой контракт купли-продажи базового актива, при заключении которого стороны договариваются только об уровне цены и сроке поставки.	цены
Католицизм	крупнейшее по численности приверженцев направление в христианстве, сформировавшееся на протяжении I тысячелетия н. э. на территории Западной Римской империи.	norm
Водород	первый элемент периодической системы элементов; обозначается символом H. H
Импрессионизм	направление в искусстве последней трети XIX - начала XX веков, зародившееся во Франции и затем распространившееся по всему миру, представители которого стремились разрабатывать методы и приёмы, которые позволяли наиболее естественно и живо запечатлеть реальный мир в его подвижности и изменчивости, передать свои мимолётные впечатления.	norm
Аммиак	NH₃, нитрид водорода, при нормальных условиях - бесцветный газ с резким характерным запахом.	chem
Шахматы	настольная логическая игра со специальными фигурами на 64-клеточной доске для двух соперников, сочетающая в себе элементы искусства, науки и спорта.	norm
Экология	наука о взаимодействиях живых организмов и их сообществ между собой и с окружающей средой.	с окружающей prep
Скифы	древний народ, существовавший в VIII в. до н. э. - IV в. н. э.	norm
Кислород	элемент 16-й группы, второго периода периодической системы химических элементов Д. И. Менделеева, с атомным номером 8.	инициалы
Мировоззрение	совокупность взглядов, оценок, принципов и образных представлений, определяющих самое общее видение, понимание мира, места в нём человека, а также - его жизненные позиции, программы поведения, действия.	видение, жизненные
Крестьянская реформа в России	начатая в 1861 году реформа, упразднившая крепостное право в Российской империи.	упразднившая
Smart TV	технология интеграции интернета и цифровых интерактивных сервисов в современные телевизоры и ресиверы цифрового телевидения, а также в техническом симбиозе между компьютерами и телевизорами / ресиверами цифрового телевидения, ранее именуемая «Connected TV»,.	/ norm
Омонимы	разные по значению, но одинаковые по звучанию и написанию слова, морфемы и другие единицы языка.	по значению, по звучанию prep
4K	обозначение разрешающей способности в цифровом кинематографе и компьютерной графике, примерно соответствующее 4000 пикселей по горизонтали.		norm
Страховой номер индивидуального лицевого счёта	сведения, содержащиеся в страховом свидетельстве обязательного пенсионного страхования или в страховом свидетельстве государственного пенсионного страхования - документе, выдаваемом застрахованному лицу, подтверждающем его регистрацию в системе государственного пенсионного страхования Российской Федерации.	пенсионного
HDMI	интерфейс для мультимедиа высокой чёткости, позволяющий передавать цифровые видеоданные высокого разрешения и многоканальные цифровые аудиосигналы с защитой от копирования.	интерфейс
Опричнина	часть государственной политики в Русском государстве, состоявшая в конфискации имущества в пользу государства, государственном терроре и системе чрезвычайных мер.	терроре
Лоботомия	форма психохирургии, нейрохирургическая операция, при которой одна из долей мозга иссекается или разъединяется с другими областями мозга.	психохирургии нейрохирургическая
Копирайтинг	профессиональная деятельность по написанию рекламных и презентационных текстов.	по написанию prep
Декабристы	участники российского оппозиционного движения, члены различных тайных обществ второй половины 1810-х - первой половины 1820-х, организовавшие антиправительственное восстание 14 декабря 1825 и получившие название по месяцу восстания.	norm
Хиппи	философия и субкультура, изначально возникшая в 1960 годах в США.	norm
База данных	представленная в объективной форме совокупность самостоятельных материалов, систематизированных таким образом, чтобы эти материалы могли быть найдены и обработаны с помощью электронной вычислительной машины (ЭВМ).	в объективной prep
2С4	советский 240-мм самоходный миномёт артиллерии резерва Верховного Главнокомандования.	norm
Цены на нефть	чаще всего понимают спотовые цены барреля нефти одного из маркерных сортов, свободно торгуемых на фьючерсном рынке, обычно североморской нефти Brent или, несколько реже, американской нефти WTI.	спотовые, WTI
Терроризм	политика, основанная на систематическом применении террора.	терроризм, террора
иовары	гипернация ололло трололо	wtf
Железо	элемент восьмой группы четвёртого периода периодической системы химических элементов Д. И. Менделеева с атомным номером 26.	инициалы
Категории годности к военной службе	следуя которым, определяется способность молодого человека служить в Вооружённых силах в целом и в частности нести службу в отдельных видах и родах войск.	родах
Оферта	предложение о заключении сделки, в котором изложены существенные условия договора, адресованное определённому лицу, ограниченному или неограниченному кругу лиц.	неограниченному
TCP/IP	набор сетевых протоколов передачи данных, используемых в сетях, включая сеть Интернет.	norm slash
Комплексное число	числа вида x+iy, где, где , где, где x и и и и y - вещественные числа, - вещественные числа, - вещественные числа, - вещественные числа, i - мнимая единица. - мнимая единица.	math
Матрица	математический объект, записываемый в виде прямоугольной таблицы элементов кольца или поля, которая представляет собой совокупность строк и столбцов, на пересечении которых находятся её элементы.	на пересечении prep кОльца
Гидроксид натрия	самая распространённая щёлочь, химическая формула NaOH.	chem
то есть последовательность чисел
Разрешение	величина, определяющая количество точек на единицу площади.	на единицу prep
Каббала	религиозно-мистическое и эзотерическое течение в иудаизме, появившееся в XII веке и получившее распространение в XVI веке.	эзотерическое
Спин-офф	художественное произведение, являющееся производным по отношению к другому, уже существующему произведению и эксплуатирующее его популярность, признание или коммерческий успех за счёт использования каких-либо элементов - персонажей, событий или тем - игравших в произведении-предшественнике второстепенную роль.	за счет prep
Сюрреализм	направление в искусстве, сформировавшееся к началу 1920-х во Франции.	norm
Сделка РЕПО	сделка покупки ценной бумаги с обязательством обратной продажи через определенный срок по заранее определенной цене.	РЕПО
Список императоров России	был принят Петром I 22 октября 1721 по просьбе Сената после победы в Северной войне и просуществовал до Февральской революции 1917.	norm, даты
Великие географические открытия	период в истории человечества, начавшийся в XV веке и продолжавшийся до XVII века, в ходе которого европейцы открывали новые земли и морские маршруты в Африку, Америку, Азию и Океанию в поисках новых торговых партнёров и источников товаров, пользовавшихся большим спросом в Европе.	землИ
Банан	название съедобных плодов культивируемых видов рода; обычно под таковыми понимают Musa acuminata и Musa × paradisiaca, а также Musa balbisiana, Musa fehi, Musa troglodytarum и ряд других.	latin
Анилингус	сексуальная практика, подразумевающая стимуляцию заднепроходной области языком или губами с целью вызвать сексуальное возбуждение и/или доставить сексуальное удовлетворение.	norm slash
Маркшейдер	горный инженер или техник, специалист по проведению пространственно-геометрических измерений в недрах земли и на соответствующих участках её поверхности с последующим отображением результатов измерений на планах, картах и разрезах при горных и геолого-разведочных работах.	на соответствующих prep
Бухгалтерский баланс	одна из пяти основных составляющих бухгалтерской отчётности.	отчетности
Маска подсети	или маской сети называется битовая маска, определяющая, какая часть IP-адреса узла сети относится к адресу сети, а какая - к адресу самого узла в этой сети.	norm, самого, сети
Джаз	форма музыкального искусства, возникшая в конце XIX - начале XX века в США в результате синтеза африканской и европейской культур и получившая впоследствии повсеместное распространение.	norm
Диоксид углерода	бесцветный газ, без запаха, со слегка кисловатым вкусом.	со слегка prep
Поисковая оптимизация	комплекс мер для поднятия позиций сайта в результатах выдачи поисковых систем по определенным запросам пользователей с целью продвижения сайта.	поисковАя
Хентай	жанр японской анимации, комиксов, а также изображений соответствующей стилистики, основным элементом которых являются содержащиеся в них эротические или порнографические сцены.	хентай
Общая теория относительности	геометрическая теория тяготения, развивающая специальную теорию относительности, опубликованная Альбертом Эйнштейном в 1915-1916 годах.	Альбертом
Смысл жизни	философская и духовная проблема, имеющая отношение к определению конечной цели существования, предназначения человечества, человека как биологического вида, а также человека как индивидуума, одно из основных мировоззренческих понятий, имеющее огромное значение для становления духовно-нравственного облика личности.	к определению, из основных prep
100 лучших злодеев комиксов по версии IGN	рейтинг злодеев комиксов, сформированный крупным независимым интернет-порталом IGN.	рейтинг
Налог	обязательный, индивидуально безвозмездный платёж, принудительно взимаемый органами государственной власти различных уровней с организаций и физических лиц в целях финансового обеспечения деятельности государства и муниципальных образований.	с организаций prep взимаемый
Ртуть	элемент шестого периода периодической системы химических элементов Д. И. Менделеева с атомным номером 80, относящийся к подгруппе цинка.	инициалы
Электрическое напряжение	физическая величина, значение которой равно отношению работы эффективного электрического поля, совершаемой при переносе пробного электрического заряда из точки A в точку B, к величине пробного заряда.	A B
Нейролингвистическое программирование	направление в психотерапии и практической психологии, не признаваемое академическим сообществом, основано на технике моделирования вербального и невербального поведения людей, добившихся успеха в какой-либо области, и наборе связей между формами речи, движением глаз, тела и памятью.	моделирования
Алканы	ациклические углеводороды линейного или разветвлённого строения, содержащие только простые связи и образующие гомологический ряд с общей формулой CH.	chem
3G	набор услуг, который объединяет как высокоскоростной мобильный доступ с услугами сети Интернет, так и технологию радиосвязи, которая создаёт канал передачи данных.	сети, радиосвязи
Список портов TCP и UDP	В данной статье приведён список номеров портов, используемых протоколами TCP/IP транспортного уровня для установки соединения между двумя хостами.	norm slash UDP
Страпон	фаллоимитатор, состоящий из трусиков-ремешков и насадки в виде фаллоса.	трусикоВ-ремешков
Глицин	простейшая алифатическая аминокислота, единственная протеиногенная аминокислота, не имеющая оптических изомеров.	протеиногенная 
Кровяное давление	давление, которое кровь оказывает на стенки кровеносных сосудов, или, по-другому говоря, превышение давления жидкости в кровеносной системе над атмосферным, один из важных признаков жизни.	над атмосферным prep жизни
Столыпинская аграрная реформа	обобщённое название широкого комплекса мероприятий в области сельского хозяйства, проводившихся правительством России под руководством П. А. Столыпина, начиная с 1906 года.	norm
Большая семёрка	международный клуб, объединяющий Великобританию, Германию, Италию, Канаду, США, Францию и Японию.	япОниЮ
Приставки СИ	приставки перед названиями или обозначениями единиц измерения физических величин, применяемые для формирования кратных и дольных единиц, отличающихся от базовой в определённое целое, являющееся степенью числа 10, число раз.	в определенное prep
Сочетание клавиш	разновидность интерфейса взаимодействия с вычислительным устройством, представляющая собой нажатие кнопки/клавиши на клавиатуре, которому назначено некое действие - команды, исполняемые данной системой.	prep на клавиатуре
Руны	письменность древних германцев, употреблялась с I-II по XII век на территории современных Дании, Швеции и Норвегии, по X-XIII век в Исландии и Гренландии, а в шведской провинции Даларна вплоть до XIX века.	norm
Инь и ян	одна из основных концепций древнекитайской натурфилософии.	prep из основных
Мегалодон	вымерший вид акул, останки которого находят в отложениях от позднего олигоцена до плейстоцена.	в отложениях prep
Удельная теплоёмкость	отношение теплоёмкости к массе, теплоёмкость единичной массы вещества; физическая величина, численно равная количеству теплоты, которое необходимо передать единичной массе данного вещества для того, чтобы его температура изменилась на единицу.	prep на единицу
Лампа накаливания	искусственный источник света, в котором свет испускает тело накала, нагреваемое электрическим током до высокой температуры.	до высокой prep
Эукариоты	домен (надцарство) живых организмов, клетки которых содержат ядра.	ядрА
Декадентство	упадок, культурный регресс; изначально использовался как исторический термин для обозначения культурных явлений Римской империи к. II-IV вв. Также этим термином обозначают модернистское направление в изобразительном искусстве, музыке, литературе и архитектуре, в творческой мысли, самовыражении как таковых - конца XIX - начала XX веков, характеризующихся извращённым эстетизмом, индивидуализмом, имморализмом.	norm модернистское
Антисемитизм	одна из форм национальной нетерпимости, выражающаяся во враждебном отношении к евреям как этнической или религиозной группе.	антисемитизм
S.T.A.L.K.E.R.	торговая марка, принадлежащая украинской компании «GSC Game World», название вымышленной вселенной, которая создана на основе повести «Пикник на обочине» братьев Стругацких и реальной Чернобыльской зоны.	norm
Гемоглобин	сложный железосодержащий белок животных, обладающих кровообращением, способный обратимо связываться с кислородом, обеспечивая его перенос в ткани.	белок
Социальный институт	исторически сложившаяся или созданная целенаправленными усилиями форма организации совместной жизнедеятельности людей, существование которой диктуется необходимостью удовлетворения социальных, экономических, политических, культурных или иных потребностей общества в целом или его части.	жизнедеятельности
Вулкан	геологические образования на поверхности коры Земли или другой планеты, где магма выходит на поверхность, образуя лаву, вулканические газы, камни.	на поверхности prep
Теория шести рукопожатий	теория, согласно которой любые два человека на Земле разделены не более чем пятью уровнями общих знакомых.	prep на Земле
Помело	вид растений из рода Цитрус; так же называются и плоды этого растения.	помело
Анархизм	политическая философия, идеология, заключающая в себе теории и взгляды, которые выступают за ликвидацию любого принудительного управления и власти человека над человеком	за ликвидацию prep
Стокгольмский синдром	термин популярной психологии, описывающий защитно-бессознательную травматическую связь, взаимную или одностороннюю симпатию, возникающую между жертвой и агрессором в процессе захвата, похищения и/или применения насилия.	norm slash
Серотонин	один из основных нейромедиаторов.	prep из основных
Золотой резерв	запас золота, находящийся в ведении центрального банка и/или министерства финансов страны, и являющийся частью золотовалютного резерва.	norm slash
Права человека	права, образующие основу правового статуса личности.	прАва
Курды	ираноязычный народ, представляющий собой совокупность многочисленных племенных групп, расселённых главным образом в районах среднего и северного Загроса и в верховьях Тигра и Евфрата - в регионе, называемом Курдистаном.	евфрата
Потери в Великой Отечественной войне	Существуют различные оценки потерь Советского Союза и Германии во время войны 1941-1945 гг. Различия связаны как со способами получения исходных количественных данных по разным группам потерь, так и с методами расчёта.	norm
Предпринимательство	экономическая деятельность, направленная на систематическое получение прибыли от производства и/или продажи товаров, оказания услуг.	norm/slash
Плацебо	вещество без явных лечебных свойств, используемое в качестве лекарственного средства, лечебный эффект которого связан с верой самого пациента в действенность препарата.	самого пациента
Орден Отечественной войны	военный орден СССР, учреждённый Указом Президиума Верховного Совета СССР «Об учреждении Ордена Отечественной Войны I и II степени» от 20 мая 1942 года.	norm I и II степени
Витамин E	группа природных соединений производных токола.	витамин E
Премия «Оскар» за лучший фильм	престижная награда Американской академии киноискусства, присуждаемая ежегодно c 1929 года.	prep за лучший
Акулы	надотряд хрящевых рыб, относящийся к подклассу пластиножаберных и обладающий следующими отличительными особенностями: удлинённое тело более или менее торпедообразной формы, большой гетероцеркальный хвостовой плавник, обычно большое количество острых зубов на каждой челюсти.	пластиножаберных
Конституция	основной закон государства, особый нормативный правовой акт, имеющий высшую юридическую силу.	высшую
Наложенный платёж	денежная сумма, которую почта взыскивает по поручению отправителя с адресата при вручении последнему почтового отправления и которая пересылается отправителю почтовым или телеграфным переводом.	prep с адресата
Антонимы	это слова одной части речи, различные по звучанию и написанию, имеющие прямо противоположные лексические значения, например: «правда» - «ложь», «добрый» - «злой», «говорить» - «молчать».	слОва, по звучанию prep
Мста-С	советская и российская 152-мм дивизионная самоходная гаубица.	norm
Езиды	курдская этноконфессиональная группа, говорящая на курманджийском языке курдской группы арийской ветви индоевропейской семьи.	езиды
Реклама	часть маркетинговых коммуникаций, в рамках которой производится оплаченное известным спонсором распространение не персонализированной информации, с целью привлечения внимания к объекту рекламирования, формирования или поддержания интереса к нему.	к объекту
Большая панда	млекопитающее семейства медвежьих со своеобразной чёрно-белой окраской шерсти, обладающее некоторыми признаками енотов.	со своеобразной
Коньяк	крепкий алкогольный напиток, производимый из определённых сортов винограда по особой технологии.	из определенных по особой prep
Логика	раздел философии, нормативная наука о формах, методах и законах интеллектуальной познавательной деятельности, формализуемых с помощью логического языка.	языка
Витамин D	группа биологически активных веществ.	D
Научный стиль	функциональный стиль речи литературного языка, которому присущ ряд особенностей: предварительное обдумывание высказывания, монологический характер, строгий отбор языковых средств, тяготение к нормированной речи.	языка языковая

Рефлексия	это обращение внимания субъекта на самого себя и на своё сознание, в частности, на продукты собственной активности, а также какое-либо их переосмысление.	на самого на свое на продукты prep
Люмпен	термин, введённый Карлом Марксом для обозначения низших слоёв пролетариата.	для обозначения prep dlya низших
Проституция	оказание сексуальных услуг за плату.	за плату prep
Дебиторская задолженность	сумма долгов, причитающихся предприятию, фирме, компании со стороны других предприятий, фирм, компаний, а также граждан, являющихся их должниками, дебиторами, что соответствует как международным, так и российским стандартам бухгалтерского учёта.		prep со стороны
Либидо	одно из основных понятий психоанализа, разработанных Фрейдом.	из основных prep
Металлы	группа элементов, в виде простых веществ, обладающих характерными металлическими свойствами, такими, как высокие тепло- и электропроводность, положительный температурный коэффициент сопротивления, высокая пластичность и металлический блеск.	тепло-
Факторинг	это комплекс услуг для производителей и поставщиков, ведущих торговую деятельность на условиях отсрочки платежа.	на условиях prep
Менструальный цикл	от menstruus - периодические изменения в организме женщины репродуктивного возраста, направленные на возможность зачатия.	prep в организме на возможность
Jack Daniel’s	вид виски.	Daniel’s
Лингвистика	наука, изучающая языки.	языки
Сталинские репрессии	массовые политические репрессии, осуществлявшиеся в СССР в период сталинизма.	массовые
Бисексуальность	в широком смысле слова феномен человеческой сексуальности, который включает или может включать в себя бисексуальную ориентацию, бисексуальную идентичность и/или бисексуальное поведение.	norm slash
Пища	то, что едят, чем питаются - любое вещество, пригодное для еды и питья живым организмам для пополнения запасов энергии и необходимых ингредиентов для нормального течения химических реакций обмена веществ: белков, жиров, углеводов, витаминов, минералов и микроэлементов.	то
Рациональное число	число, представляемое обыкновенной дробью \frac{m}{n}, числитель, числитель , числитель, числитель m - целое число, а знаменатель - целое число, а знаменатель - целое число, а знаменатель - целое число, а знаменатель n - натуральное число, к примеру 2/3. - натуральное число, к примеру 2/3. - натуральное число, к примеру 2/3. - натуральное число, к примеру 2/3.	math
БТР-80	советский бронетранспортёр.	бронетранспортёр
Хлорид натрия	натриевая соль соляной кислоты.	 соляной
Переменный ток	электрический ток, который с течением времени изменяется по величине и направлению или, в частном случае, изменяется по величине, сохраняя своё направление в электрической цепи неизменным.	по величине prep
Троллинг	форма социальной провокации в сетевой коммуникации, использующаяся как персонифицированными участниками, заинтересованными в большей узнаваемости, публичности, эпатаже, так и анонимными пользователями без возможности их идентификации.	заинтересованными
Амбидекстрия	врождённое или выработанное в тренировке равное развитие функций обеих рук, без выделения ведущей руки, и способность человека выполнять двигательные действия правой и левой рукой с одинаковой скоростью и эффективностью.	prep с одинаковой
Пиндос	слово, присутствующее в разговорном варианте русского и украинского языков, и употребляемое в России, Белоруссии и на Украине в нескольких смыслах, основными из которых является повсеместно распространённое на постсоветском пространстве с начала XXI века инвективное наименование американцев (граждан США), а также распространённое в Северном Причерноморье и Приазовье с XIX века бытовое прозвище местных греков.	с началА постсоветском
Геометрическая прогрессия	последовательность чисел b_1,\ b_2,\ b_3,\ \ldots, в которой каждое последующее число, начиная со второго, получается из предыдущего умножением его на определённое число, в которой каждое последующее число, начиная со второго, получается из предыдущего умножением его на определённое число , в которой каждое последующее число, начиная со второго, получается из предыдущего умножением его на определённое число, в которой каждое последующее число, начиная со второго, получается из предыдущего умножением его на определённое число q \quad, где, где , где, где b_1\not=0, , q\not=0: : : : b_1,\ b_2=b_1q,\ b_3=b_2q,\ \ldots,\ b_n=b_{n-1}q..	math
2С5	советская 152-мм армейская самоходная пушка.	norm
Стагнация	состояние экономики, характеризующееся застоем производства и торговли на протяжении длительного периода.	prep на протяжении
Метан	простейший углеводород, бесцветный газ без запаха, химическая формула - CH₄.	chem
Near field communication	технология беспроводной высокочастотной связи малого радиуса действия, которая дает возможность обмена данными между устройствами, находящимися на расстоянии около 10 сантиметров; анонсирована в 2004 г.	на расстоянии prep
Частота	физическая величина, характеристика периодического процесса, равна количеству повторений или возникновения событий в единицу времени.	в единицу
Себестоимость	это стоимостная оценка используемых в процессе производства продукции природных ресурсов, сырья, материалов, топлива, энергии, основных фондов, трудовых ресурсов и других затрат на ее производство и реализацию.	на ее prep
Напряжённость электрического поля	векторная физическая величина, характеризующая электрическое поле в данной точке и численно равная отношению силы \vec F, действующей на неподвижный точечный заряд, помещенный в данную точку поля, к величине этого заряда действующей на неподвижный точечный заряд, помещенный в данную точку поля, к величине этого заряда действующей на неподвижный точечный заряд, помещенный в данную точку поля, к величине этого заряда действующей на неподвижный точечный заряд, помещенный в данную точку поля, к величине этого заряда q: : : : : : : : \vec E= \frac{\vec F}{q}..	math
Магнитное поле	силовое поле, действующее на движущиеся электрические заряды и на тела, обладающие магнитным моментом, независимо от состояния их движения; магнитная составляющая электромагнитного поля.	prep homog на тела
Нэнси Дрю	серия игр о девушке-сыщице Нэнси Дрю, созданная по мотивам серии книг написанной группой писателей, выпускавшейся под псевдонимом Кэролайн Кин.	prep по мотивам под псевдонимом
Постмодернизм	термин, обозначающий структурно сходные явления в мировой общественной жизни и культуре второй половины XX века: он употребляется как для характеристики постнеклассического типа философствования, так и для комплекса стилей в художественном искусстве.	постмодернизм
Хронология истории России	и события, происходившие на территориях, когда-либо занимаемых Россией.	на территориях prep
e	основание натурального логарифма, математическая константа, иррациональное и трансцендентное число.	e
Алкены	ациклические непредельные углеводороды, содержащие одну двойную связь между атомами углерода, образующие гомологический ряд с общей формулой CnH2n.	chem
Горизонт событий	воображаемая граница в пространстве-времени, разделяющая те события, которые можно соединить с событиями на светоподобной бесконечности светоподобными геодезическими линиями, и те события, которые так соединить нельзя.	геодезическими
Эволюция	естественный процесс развития живой природы, сопровождающийся изменением генетического состава популяций, формированием адаптаций, видообразованием и вымиранием видов, преобразованием экосистем и биосферы в целом.	генетического
Турмалин	минерал из группы боросодержащих алюмосиликатов, сложные боросиликаты переменного состава.	боросиликаты
Анастасия	женское имя, женская форма мужского имени Анастасий, в переводе с древнегреческого языка - «воскресение».	языка
Щитовидная железа	эндокринная железа у позвоночных, хранящая йод и вырабатывающая йодсодержащие гормоны, участвующие в регуляции обмена веществ и росте отдельных клеток, а также организма в целом - тироксин и трийодтиронин.	железа трийодтиронин
Мерчандайзер	товаровед или помощник товароведа, человек, представляющий торговую компанию в торговых сетях. Отвечает за выкладку товара, установку сопутствующего необходимого оборудования, размещает POS-материалы. Основная задача - контроль наличия всего ассортимента компании на полках магазина и расположение его в наиболее благоприятных для покупки местах.	за выкладку
Живопись	вид изобразительного искусства, связанный с передачей зрительных образов посредством нанесения красок на жёсткую или гибкую поверхность.	жесткую
Аляскинский маламут	это достаточно крупная собака аборигенного типа, предназначенная для работы в упряжке,.	упряжке
Бензин	горючая смесь лёгких углеводородов с температурой кипения от 33 до 205 °C.	бензин
Порноактёр	участник порнографических фильмов или фотографий, живых сексуальных показов или пип-шоу.	порноактер
Постиндустриальное общество	общество, в экономике которого преобладает инновационный сектор экономики с высокопроизводительной промышленностью, индустрией знаний, с высокой долей в ВВП высококачественных и инновационных услуг, с конкуренцией во всех видах экономической и иной деятельности.	постиндустриальное
Упрощённая система налогообложения	специальный налоговый режим, направленный на снижение налоговой нагрузки на субъекты малого бизнеса и среднего бизнеса, а также облегчение и упрощение ведения налогового учёта и бухгалтерского учёта.	на снижение на субъекты	prep
Full HD	маркетинговое название, впервые введённое компанией Sony в 2007 году для ряда продуктов.	введенное
URL	единообразный локатор ресурса.	URL
Чай	напиток, получаемый варкой, завариванием и/или настаиванием листа чайного куста, который предварительно подготавливается специальным образом.	norm slash
Старообрядчество	совокупность религиозных течений и организаций в русле русской православной церкви, отвергающих предпринятую в 1650-х - 1660-х патриархом Никоном и царём Алексеем Михайловичем церковную реформу, целью которой была унификация богослужебного чина Русской Церкви с греческой Церковью и прежде всего - с Церковью Константинопольской.	norm старообрядчество
Гештальт-терапия	гуманистическое направление в психотерапии, основанное на экспериментально-феноменологическом и экзистенциальном подходах.	экзистенциальном
Овердрафт	кредитование банком расчётного счёта клиента, для оплаты им расчётных документов, при недостаточности или отсутствии на расчётном счёте клиента-заемщика денежных средств.	овердрафт
Биология	система наук, объектами изучения которой являются живые существа и их взаимодействие с окружающей средой.	с окружающей prep
2С1	советская 122-мм полковая самоходная гаубица.	norm
Гомофобия	собирательное определение для различных форм негативной реакции на проявления гомосексуальности, а также на связанные с ней общественные явления.	явления
Расизм	совокупность воззрений, в основе которых лежат положения о физической и умственной неравноценности человеческих рас, нации и о решающем влиянии расовых различий на историю и культуру.	в основе prep
Пентаграмма	правильный пятиугольник, стороны которого продлены до точек пересечения, и образуют равнобедренные треугольники на его гранях, то есть - звёздчатая форма правильного пятиугольника.	стороны homog
Катализатор энергии Росси	аппаратура, созданная изобретателем Андреа Росси при поддержке научного консультанта физика Серджо Фокарди, и которая по представлению автора реализует реакцию холодного термоядерного синтеза с положительным выходом энергии.	prep по представлению
Рыночная экономика	По мнению ряда экономистов, «рынок», под чем принято понимать основанную на свободе договора, ценообразовании по закону спроса и предложения и встречном обороте денежной массы представляет собой не более чем одну из исторически обусловленных и исторически приходящих форм товарообмена и товарораспределения.	на свободе prep
DHCP	сетевой протокол, позволяющий компьютерам автоматически получать IP-адрес и другие параметры, необходимые для работы в сети TCP/IP.	norm slash сети
Омега-3-ненасыщенные жирные кислоты	относятся к семейству ненасыщенных жирных кислот, имеющих двойную углерод-углеродную связь в омега-3-позиции, то есть после третьего атома углерода, считая от метилового конца цепи жирной кислоты.  norm ненасыщенных
Флешмоб	это заранее спланированная массовая акция, в которой большая группа людей появляется в общественном месте, выполняет заранее оговоренные действия и затем расходится.	в общественном prep
Этнос	исторически сложившаяся устойчивая совокупность людей, объединённых общими объективными либо субъективными признаками, в которые входят различные направления этнологии включающие происхождение, язык, культуру, территорию проживания, самосознание и др.	norm
Конфуцианство	этико-философское учение, разработанное Конфуцием и развитое его последователями, вошедшее в религиозный комплекс Китая, Кореи, Японии и некоторых других стран.	развитое
Високосный год	год в юлианском и григорианском календарях, продолжительность которого равна 366 дням - на одни сутки больше продолжительности обычного, невисокосного года.	на одни prep
Восточные славяне	культурно-языковая общность славян, говорящих на восточнославянских языках.	языковая
Аккредитив	условное денежное обязательство, принимаемое банком по поручению приказодателя.	по поручению prep приказодателя
Чрезвычайная ситуация	это обстановка, сложившаяся на определенной территории или акватории в результате аварии, опасного природного явления, катастрофы, стихийного или иного бедствия, которые могут повлечь или повлекли за собой человеческие жертвы, ущерб здоровью людей или окружающей природной среде, значительные материальные потери и нарушение условий жизнедеятельности людей.	на определенной prep
Сноб	человек, восхищающийся высшим обществом и тщательно подражающий его манерам и вкусам, ищущий возможность попасть в такое общество.	высшим
Средства массовой информации	система органов публичной передачи информации с помощью технических средств; до сих пор более употребительное в русском языке обозначение средств повседневной практики сбора, обработки и распространения сообщений массовым аудиториям.	до сих пор массовой
Раса	система популяций человека, характеризующаяся сходством по комплексу определённых наследственных биологических признаков, имеющих внешнее фенотипическое проявление и сформировавшихся в определенном географическом регионе.	комплексу
Вексель	ценная бумага, оформленная по строго установленной форме, удостоверяющая перетекание одного денежного обязательства в другое обязательство и дающая право лицу, которому вексель передан на основании соответствующего договора на получение от должника по договору и векселю, определённой в нём суммы в денежном эквиваленте.	на основании по договору prep
Гражданское общество	это сфера самопроявления свободных граждан и добровольно сформировавшихся некоммерчески направленных ассоциаций и организаций, независимая от прямого вмешательства и произвольной регламентации со стороны государственной власти и бизнеса. prep со стороны
Давление	физическая величина, численно равная силе F, действующей на единицу площади поверхности S перпендикулярно этой поверхности. на единицу prep и j
Коучинг	метод консалтинга и тренинга, в процессе которого человек, называющийся «коуч», помогает обучающемуся достичь некой жизненной или профессиональной цели.	коуч
Окно Овертона	модель в философии, призванная объяснить направление государственной политики, аспекты общественной жизни через зависимость от общественного мнения: из всех возможных вариантов на уровне государства и общества поддерживаются лишь те, которые попадают в определённый промежуток - «окно Овертона», другие идеи отметаются как слишком радикальные.	в определенный prep жизни
Молоко	питательная жидкость, вырабатываемая молочными железами самок млекопитающих.	железами
Кельты	близкие по языку и материальной культуре племена индоевропейского происхождения, в древности на рубеже эр занимавшие обширную территорию в Западной и Центральной Европе.	по языку
Доменное имя	символьное имя, служащее для идентификации областей - единиц административной автономии в сети Интернет - в составе вышестоящей по иерархии такой области.	в сети Homog
Растения	биологическое царство, одна из основных групп многоклеточных организмов, включающая в себя в том числе мхи, папоротники, хвощи, плауны, голосеменные и цветковые растения.	prep из основных
Метанол	CH₃OH, простейший одноатомный спирт, бесцветная ядовитая жидкость.	chem
Международный фонетический алфавит	система знаков для записи транскрипции на основе латинского алфавита.	prep на основе
T-14	российский основной танк, и средний танк по массе, на гусеничной платформе «Армата».	Т
Семантика	раздел лингвистики, изучающий смысловое значение единиц языка.	языка
Аффилированное лицо	физическое или юридическое лицо, способное оказывать влияние на деятельность юридических и/или физических лиц, осуществляющих предпринимательскую деятельность.	norm slash
Принцип неопределённости	фундаментальное соображение, устанавливающее предел точности одновременного определения пары характеризующих систему квантовых наблюдаемых, описываемых некоммутирующими операторами.	соображение
Вирус Эпштейна - Барр	вид вирусов семейства герпесвирусов.	герпесвирусов
Сублимация	защитный механизм психики, представляющий собой снятие внутреннего напряжения с помощью перенаправления энергии на достижение социально приемлемых целей, творчество.	на достижение prep
Язык	знаковая система, соотносящая понятийное содержание и типовое звучание.	соотносящая
Экономическая система	совокупность всех экономических процессов, совершающихся в обществе на основе сложившихся в нём отношений собственности и хозяйственного механизма.	на основе prep
Преступление	правонарушение, совершение которого влечёт применение к лицу мер уголовной ответственности	правонарушение
Тираннозавр	род плотоядных динозавров из группы целурозавров, подотряда теропод, включающий единственный вид - Tyrannosaurus rex.	latin тираннозавр
Экосистема	биологическая система, состоящая из сообщества живых организмов, среды их обитания, системы связей, осуществляющей обмен веществом и энергией между ними.	экосистема
Апатия	симптом, выражающийся в безразличии, безучастности, в отрешённом отношении к происходящему вокруг, в отсутствии стремления к какой-либо деятельности.	в отсутствии prep
Дауншифтинг	термин, обозначающий жизненную философию «жизни ради себя», «отказа от чужих целей».	жизненную жизни
Кремний	элемент главной подгруппы четвёртой группы третьего периода периодической системы химических элементов Д. И. Менделеева, с атомным номером 14.	norm инициалы
Закон Парето	эмпирическое правило, названное в честь экономиста и социолога Вильфредо Парето, в наиболее общем виде формулируется как «20% усилий дают 80% результата, а остальные 80% усилий - лишь 20% результата». парето
Литр	внесистемная метрическая единица измерения объёма и вместимости, равная 1 кубическому дециметру.	norm
Электрическое сопротивление	физическая величина, характеризующая свойства проводника препятствовать прохождению электрического тока и равная отношению напряжения на концах проводника к силе тока, протекающего по нему.	prep по нему
МТ-ЛБ	советский плавающий бронетранспортёр.	МТ-ЛБ
Концепция	определённый способ понимания, трактовки каких-либо явлений, основная точка зрения, руководящая идея для их освещения; система взглядов на явления в мире, в природе, в обществе; ведущий замысел, конструктивный принцип в научной, художественной, технической, политической и других видах деятельности; комплекс взглядов, связанных между собой и вытекающих один из другого, система путей решения выбранной задачи.	 на явления явлений prep
Резистор	пассивный элемент электрических цепей, обладающий определённым или переменным значением электрического сопротивления, предназначенный для линейного преобразования тока в напряжение и напряжения в ток, ограничения тока, поглощения электрической энергии и др.	norm
Заземление	преднамеренное электрическое соединение какой-либо точки сети, электроустановки или оборудования с заземляющим устройством.		сети homog
Промышленная революция	переход от ручного труда к машинному, от мануфактуры к фабрике, наблюдавшийся в ведущих западных державах в XVIII-XIX веках.	norm
Список выпусков телепередачи «Следствие вели…»	В данном списке представлены серии документальной телепередачи «Следствие вели…» Цикл этих документальных фильмов выходит с января 2006 года на телеканале НТВ.	на телеканале prep
Пауки	отряд членистоногих, второй по числу известных представителей в классе паукообразных: около 42 тысяч современных и около 1,1 тысячи ископаемых видов.	prep по числу
Витамины группы B	группа водорастворимых витаминов, играющих большую роль в клеточном метаболизме и улучшении организма.	группа В
Цвет	качественная субъективная характеристика электромагнитного излучения оптического диапазона, определяемая на основании возникающего физиологического зрительного ощущения и зависящая от ряда физических, физиологических и психологических факторов.	возникающая
Мизантропия	отчуждение от людей, ненависть к ним; нелюдимость.	отчуждение
Отче наш	главная молитва в христианстве.	отче
Энцефалопатия	общее название для невоспалительных заболеваний головного мозга.	dlya prep
Тригонометрические тождества	математические выражения для тригонометрических функций, которые выполняются при всех значениях аргумента.	prep dlya
Диффузия	процесс взаимного проникновения молекул или атомов одного вещества между молекулами или атомами другого, приводящий к самопроизвольному выравниванию их концентраций по всему занимаемому объёму.	prep по всему
Масштаб	в общем случае отношение двух линейных размеров.	масштаб 
Коэффициент полезного действия	характеристика эффективности системы в отношении преобразования или передачи энергии.	prep в отношении
Digital Visual Interface	стандарт на интерфейс и соответствующий разъём, предназначенный для передачи видеоизображения на цифровые устройства отображения, такие как жидкокристаллические мониторы, телевизоры и проекторы.	interface видеоизображения prep dlya
Blu-ray disc	формат оптического носителя, используемый для записи с повышенной плотностью хранения цифровых данных, включая видео высокой чёткости.	prep dlya
Готика	период в развитии средневекового искусства на территории Западной, Центральной и отчасти Восточной Европы с XI - XII по XV-XVI века.	norm prep на территории
Артхаус	кинопрокатная ниша, в которую попадают фильмы, не рассчитанные на широкую аудиторию, демонстрирующиеся, как правило, в специализированных кинотеатрах.	рассчитанные
Уксусная кислота	органическое вещество с формулой CH₃COOH. Слабая, предельная одноосновная карбоновая кислота.	chem
Закон сохранения энергии	фундаментальный закон природы, установленный эмпирически и заключающийся в том, что для изолированной физической системы может быть введена скалярная физическая величина, являющаяся функцией параметров системы и называемая энергией, которая сохраняется с течением времени.	введена
Эдипов комплекс	понятие, введённое в психоанализ Зигмундом Фрейдом, обозначающее бессознательное сексуальное влечение к родителю противоположного пола и амбивалентные чувства к родителю того же пола.	введенное
Реинкарнация	группа религиозно-философских доктрин, согласно которым бессмертная сущность живого существа перевоплощается снова и снова из одного тела в другое.		из одного prep
Муравьи	семейство насекомых из надсемейства муравьиных отряда перепончатокрылых.	перепончатокрылых
Креационизм	теологическая и мировоззренческая концепция, согласно которой основные формы органического мира, человечество, планета Земля, а также мир в целом, рассматриваются как непосредственно созданные Творцом или Богом.	креационизм
Стафилококки	род бактерий семейства Staphylococcaceae.	latin
SMART	это мнемоническая аббревиатура, используемая в менеджменте и проектном управлении для определения целей и постановки задач.	prep dlya
Хостинг	услуга по предоставлению вычислительных мощностей для размещения информации на сервере, постоянно находящемся в сети.	prep по предоставлению сети homog
Список персонажей Marvel Comics	появлявшихся во Вселенной Marvel, который включает большинство вымышленных персонажей, созданных Marvel Comics и принадлежащих ей. Залицензированные или принадлежащие создателям персонажи не включены.	залицензированные
Витамин A	группа близких по химическому строению веществ, которая включает ретинол и другие ретиноиды, обладающие сходной биологической активностью: дегидроретинол, ретиналь и ретиноевую кислоту.	А, дегидроретинол
Ром	крепкий спиртной напиток, изготавливаемый путём сбраживания и перегонки из побочных продуктов сахарно-тростникового производства, таких, как патока и тростниковый сироп.	тростниковый
Кинетическая энергия	скалярная функция, являющаяся мерой движения материальной точки и зависящая только от массы и модуля скорости материальных точек, образующих рассматриваемую физическую систему, энергия механической системы, зависящая от скоростей движения её точек в выбранной системе отсчёта.	кинетическая
Идеология	совокупность системно упорядоченных взглядов, выражающая интересы различных социальных классов и других социальных групп, на основе которой осознаются и оцениваются отношения людей и их общностей к социальной действительности в целом и друг к другу и либо признаются установленные формы господства и власти, либо обосновывается необходимость их преобразования и преодоления.	на основе	prep
Калибр	диаметр канала ствола по нарезам или полям; одна из основных величин, определяющих мощность огнестрельного оружия.	prep из основных по нарезам
Биосфера	оболочка Земли, заселённая живыми организмами, находящаяся под их воздействием и занятая продуктами их жизнедеятельности; «плёнка жизни»; глобальная экосистема Земли.	жизни жизнедеятельности
Эластичность спроса	позволяет почти точно измерить степень реакции покупателя на изменение цен, уровня доходов или других факторов.	на изменение prep
Пластмассы	органические материалы, основой которых являются синтетические или природные высокомолекулярные соединения.	материалы
Титан	элемент побочной подгруппы четвёртой группы, четвёртого периода периодической системы химических элементов Д. И. Менделеева, с атомным номером 22. Простое вещество титан - лёгкий прочный металл серебристо-белого цвета.	norm 
Химия	одна из важнейших и обширных областей естествознания, наука о веществах, их составе и строении, их свойствах, зависящих от состава и строения, их превращениях, ведущих к изменению состава - химических реакциях, а также о законах и закономерностях, которым эти превращения подчиняются.	подчиняются
Пространство-время	физическая модель, дополняющая пространство равноправным временным измерением и таким образом создающая теоретико-физическую конструкцию, которая называется пространственно-временным континуумом.	континуумом
Т-34-85	советский средний танк периода Великой Отечественной войны.	norm
Соляная кислота	HCl, раствор хлороводорода в воде; сильная одноосновная кислота.	chem
Электрон	стабильная, отрицательно заряженная элементарная частица, одна из основных структурных единиц вещества.	из основных prep
Нервная система	целостная морфологическая и функциональная совокупность различных взаимосвязанных нервных структур, которая совместно с эндокринной системой обеспечивает взаимосвязанную регуляцию деятельности всех систем организма и реакцию на изменение условий внутренней и внешней среды.	prep на изменение
Поливинилхлорид	бесцветная, прозрачная пластмасса, термопластичный полимер винилхлорида.	термопластичный
Крепостное право в России	существовавшая, начиная с Киевской Руси XI века, система правоотношений, вытекавших из зависимости земледельца, крестьянина, от помещика, владельца земли, населяемой и обрабатываемой крестьянином.	правоотношений
Фонетика	раздел лингвистики, изучающий звуки речи и звуковое строение языка.	языка
Верификация	могут подразумеваться разные понятия.	понятия
A3	страница значений	A3
Децибел	логарифмическая единица уровней, затуханий и усилений.	децибел
Сапфир	драгоценный камень различных оттенков, одна из разновидностей корунда.	оттенков
Краудфандинг	это коллективное сотрудничество людей, которые добровольно объединяют свои деньги или другие ресурсы вместе, как правило через Интернет, чтобы поддержать усилия других людей или организаций.	краудфандинг
Ньютон	единица измерения силы в Международной системе единиц (СИ).	ньютон homog
Импульс	векторная физическая величина, являющаяся мерой механического движения тела.	являющаяся
Знаки валют	буква, лигатура, монограмма, знак (символ), иероглиф, сокращение или аббревиатура, полное слово, а также их комбинации, используемые для максимально краткого и в то же время уникального обозначения валюты.	prep dlya
Внутренняя энергия	принятое в физике сплошных сред, термодинамике и статистической физике название для той части полной энергии термодинамической системы, которая не зависит от выбора системы отсчета и которая в рамках рассматриваемой проблемы может изменяться.	prep dlya	
Нирвана	понятие в индийской религиозной мысли, обозначающее высшую цель всех живых существ и играющее важнейшую роль в буддизме.	высшую
Сетевой маркетинг	концепция реализации товаров и услуг, основанная на создании сети независимых дистрибьюторов, каждый из которых, помимо сбыта продукции, также обладает правом на привлечение партнёров, имеющих аналогичные права.	на создании prep
Антигистаминные препараты	группа лекарственных средств, осуществляющих конкурентную блокаду рецепторов гистамина в организме, что приводит к торможению опосредуемых им эффектов.	prep в организме
Английская Премьер-лига	профессиональная футбольная лига для английских футбольных клубов.	премьер лига
Система	множество элементов, находящихся в отношениях и связях друг с другом, которое образует определённую целостность, единство.	 в отношениях
Паладин	название высших придворных, военных и гражданских чинов при дворе римских и византийских императоров; рыцарь из высшего сословия, фанатично преданный какой-либо идее или какому-либо человеку.	высших
Определитель	одно из основных понятий линейной алгебры.	из основных prep
Соционика	концепция типов личности и взаимоотношений между ними, основанная на типологии Юнга и теории информационного метаболизма А. Кемпинского, согласно которой «информационный метаболизм» аналогичен энергетическому метаболизму в организме.	А. Кемпинского prep в организме
Печень	жизненно важная железа внешней секреции позвоночных животных, в том числе и человека, находящаяся в брюшной полости под диафрагмой и выполняющая большое количество различных физиологических функций.	желЕза homog prep под диафрагмой
CEO	высшее должностное лицо компании.	СЕО
Угловая скорость	векторная величина, являющаяся псевдовектором (аксиальным вектором) и характеризующая скорость вращения материальной точки вокруг центра вращения.	пвсевдовектором являющаяся
Дизайн	деятельность по проектированию эстетических свойств промышленных изделий, а также результат этой деятельности.	по проектированию prep
Интерактивные подходы	это определенный тип деятельности учащихся, связанный с изучением учебного материала в ходе интерактивного урока.	материала
2С3	советская 152-мм дивизионная самоходная гаубица.	norm
Конфликт	наиболее острый способ разрешения противоречий в интересах, целях, взглядах, возникающих в процессе социального взаимодействия, заключающийся в противодействии участников этого взаимодействия и обычно сопровождающийся негативными эмоциями, выходящий за рамки правил и норм.	возникающий
Гормоны	биологически активные вещества органической природы, вырабатывающиеся в специализированных клетках желёз внутренней секреции, поступающие в кровь, связывающиеся с рецепторами клеток-мишеней и оказывающие регулирующее влияние на обмен веществ и физиологические функции.	на обмен
Временное правительство России	высший исполнительно-распорядительный и законодательный орган государственной власти в России в период между Февральской и Октябрьской революциями.	высший
Хурма	род субтропических и тропических листопадных или вечнозелёных деревьев и кустарников семейства Эбеновые.	вечнозелёных
Эстетика	философское учение о сущности и формах прекрасного в художественном творчестве, в природе и в жизни, об искусстве как особой форме общественного сознания.	эстетика
Немецкий язык	язык немцев, австрийцев, лихтенштейнцев и большей части швейцарцев, официальный язык Германии, Австрии, Лихтенштейна, один из официальных языков Швейцарии, Люксембурга и Бельгии.	лихтенштейнцев
Метонимия	вид тропа, словосочетание, в котором одно слово замещается другим, обозначающим предмет, находящийся в той или иной связи с предметом, который обозначается замещаемым словом.	тропА homog
Архитектура	искусство и наука строить, проектировать здания и сооружения, а также сама совокупность зданий и сооружений, создающих пространственную среду для жизни и деятельности человека.	жизни prep dlya
Адиабатический процесс	термодинамический процесс в макроскопической системе, при котором система не обменивается теплотой с окружающим пространством.	с окружающим prep
Сионизм	политическое движение, целью которого является объединение и возрождение еврейского народа на его исторической родине - в Израиле, а также идеологическая концепция, на которой это движение основывается.	prep на которой на его
Жизнь	активная форма существования материи, в некотором смысле высшая по сравнению с её физической и химической формами существования; совокупность физических и химических процессов, протекающих в клетке, позволяющих осуществлять обмен веществ и её деление.	жизнь
Мандала	сакральное схематическое изображение либо конструкция, используемая в буддийских и индуистских религиозных практиках.	мандала
Символизм	одно из крупнейших направлений в искусстве, возникшее во Франции в 1870-80-х гг. и достигшее наибольшего развития на рубеже XIX и XX веков, прежде всего в самой Франции, Бельгии и России.	самОй homog norm
Йоркширский терьер	декоративная порода собак, выведенная в Англии, графстве Йоркшир в конце XIX в. История породы ещё очень коротка.	norm йоркширский
Ureaplasma urealyticum	Уреаплазмоз - инфекция, вызываемая малыми микроорганизмами Ureaplasma urealyticum, относящимся к Грам-отрицательным микробам, имеющим дополнительную липидную мембрану, скрывающую клеточную стенку.	latin
Бюрократия	под этим словом подразумевают то направление, которое принимает государственное управление в странах, где все дела сосредоточены в руках органов центральной правительственной власти, действующих по предписанию и через предписание; также под бюрократией подразумевают класс лиц, резко выделенный из остального общества и состоящий из этих представителей центральной правительственной власти.	prep под бюрократией
Список лауреатов Нобелевской премии по литературе	престижная награда, ежегодно вручаемая Нобелевским фондом за достижения в области литературы.	prep по литературе
Возникновение жизни	процесс превращения неживой природы в живую.	возникновение жизни
Исполнительная власть	один из видов самостоятельной и независимой публичной власти в государстве, представляющий собой совокупность полномочий по управлению государственными делами.	по управлению prep
Глинтвейн	горячий алкогольный напиток на основе красного вина, нагретого до 70-80 градусов с сахаром и пряностями. prep на основе norm
Часть речи	категория слов языка, определяемая морфологическими и синтаксическими признаками.	языка
Экспонента	показательная функция f=\exp=e^x, где e - число Эйлера., где e - число Эйлера.	math
Размеры одежды	некоторый буквенный или цифровой код, соответствующий определённым линейным параметрам человеческого тела либо его частей, для которого предназначена данная деталь одежды.		prep dlya
Интернет	всемирная система объединённых компьютерных сетей для хранения и передачи информации.	prep dlya
Маркетинг	это организационная функция и совокупность процессов создания, продвижения и предоставления продукта или услуги покупателям и управление взаимоотношениями с ними с выгодой для организации.	prep dlya
Насвай	вид некурительного табачного изделия, традиционный для Центральной Азии.	prep dlya
USB	последовательный интерфейс передачи данных для среднескоростных и низкоскоростных периферийных устройств в вычислительной технике.	prep dlya
Русский мат	в русском и близких к нему языках, бранные слова и выражения, употребление которых не допускается общественной моралью, предназначенные преимущественно для оскорбления адресата или отрицательных оценок людей и явлений, наиболее грубая, обсценная разновидность ненормативной лексики.	prep dlya
Кавычки	парный знак препинания, который употребляется для выделения прямой речи, цитат, отсылок, названий предприятий, литературных произведений, газет, журналов, а также отдельных слов, если они включаются в текст не в своём обычном значении, используются в ироническом смысле, предлагаются впервые или, наоборот, как устаревшие и т. п.	prep dlya
Электронная сигарета	ингалятор специального назначения для личного пользования с аэрозольным генератором сверхмалой мощности. prep dlya
Чёрный дельфин	исправительная колония особого режима для пожизненно осуждённых в городе Соль-Илецк рядом с озером Развал.	prep dlya
Язык программирования	формальная знаковая система, предназначенная для записи компьютерных программ.	prep dlya
Строительные материалы	материалы для возведения и ремонта зданий и сооружений.	prep dlya
Фолиевая кислота	водорастворимый витамин, необходимый для роста и развития кровеносной и иммунной систем.	prep dlya
Ноотропы	лекарственные средства, предназначенные для оказания специфического воздействия на высшие функции мозга.	prep dlya
Нуар	кинематографический термин, применяемый к голливудским криминальным драмам 1940-х - 1950-х годов, в которых запечатлена атмосфера пессимизма, недоверия, разочарования и цинизма, характерная для американского общества во время Второй мировой войны и в первые годы холодной войны.	prep dlya
Хромосома	нуклеопротеидные структуры в ядре эукариотической клетки, в которых сосредоточена большая часть наследственной информации и которые предназначены для её хранения, реализации и передачи.	prep dlya
Овердрафт	кредитование банком расчётного счёта клиента, для оплаты им расчётных документов, при недостаточности или отсутствии на расчётном счёте клиента-заемщика денежных средств.	prep dlya
Содомия	исторический термин, гипероним для обозначения различных форм сексуального поведения, оцениваемого как девиантное, и имеющий богословскую и правовую окраску.	prep dlya
Мейнстрим	преобладающее направление в какой-либо области для определённого отрезка времени.	prep dlya
Интеграл	сумма каких-либо чисел, предназначенных для их интегрирования	prep dlya
Пауэрлифтинг	силовой вид спорта, суть которого заключается в преодолении сопротивления максимально тяжелого для спортсмена веса.	prep dlya
Кальян	прибор для курения, позволяющий фильтровать и охлаждать вдыхаемый дым.	prep dlya
Товарный знак	обозначение, «служащее для индивидуализации товаров юридических лиц или индивидуальных предпринимателей».
Scrum	методология управления проектами, активно применяющаяся при разработке информационных систем для гибкой разработки программного обеспечения.	prep dlya
ЛГБТ	аббревиатура, возникшая в английском языке для обозначения лесбиянок, геев, бисексуалов и трансгендеров.	prep dlya
Замечательные пределы	термин, использующийся в советских и российских учебниках по математическому анализу для обозначения некоторых широко известных математических тождеств со взятием предела.	prep dlya
Факторы производства	ресурсы, необходимые для производства товаров и услуг.	prep dlya
Музыка	искусство, средством воплощения художественных образов для которого являются звук и тишина, особым образом устроенные во времени.	prep dlya
Внутренняя энергия	принятое в физике сплошных сред, термодинамике и статистической физике название для той части полной энергии термодинамической системы, которая не зависит от выбора системы отсчета и которая в рамках рассматриваемой проблемы может изменяться.	prep dlya
Кускус	пшеничная крупа, которая служит основой для одноимённого блюда магрибского или берберского происхождения.	prep dlya
DNS	компьютерная распределённая система для пол	prep dlya
Информатика	наука о методах и процессах сбора, хранения, обработки, передачи, анализа и оценки информации, обеспечивающих возможность её использования для принятия решений.	prep dlya
Регистрационные знаки транспортных средств в России	специальный символический знак, изготовленный на металлические пластины или транспортное средство, используемое для учёта автомобилей, мотоциклов, грузовой, специальной, строительной техники и вооружения, прицепов.	prep dlya
Половой акт	генитальный контакт двух особей с целью получения полового удовлетворения, а также для продолжения рода.	prep dlya
Гражданское право	отрасль права, объединяющая правовые нормы, регулирующие имущественные, а также связанные и не связанные с ними личные неимущественные отношения, которые основаны на независимости оценки, имущественной самостоятельности и юридическом равенстве сторон, в целях создания наиболее благоприятных условий для удовлетворения частных потребностей, а также нормального развития экономических отношений.	prep dlya
Ископаемый уголь	полезное ископаемое, вид топлива, образовавшийся из частей древних растений под землей без доступа кислорода.	prep pod 
Золотовалютные резервы	высоколиквидные активы, находящиеся под контролем государственных органов денежно-кредитного регулирования.	prep pod
Нигилизм	мировоззренческая позиция, ставящая под сомнение общепринятые ценности, идеалы, нормы нравственности, культуры.	prep pod
Тигр	немецкий тяжёлый танк времён Второй мировой войны, прототипом которого являлся танк VK4501, разработанный в 1942 году фирмой «Хеншель» под руководством Эрвина Адерса.	prep pod

