По данным русской википедии: Судный день - фантастический постапокалиптический боевик с элементами триллера 2008 года, снятый режиссёром Нилом Маршаллом.
Незнайка - литературный персонаж, описываемый как представитель племени маленьких человечков - коротышек, герой посвящённой его приключениям трилогии Николая Носова и её многочисленных продолжений.
Зверополис - ожидаемый комедийный приключенческий мультфильм режиссёра Байрона Ховарда, продюсируемый Walt Disney Animation Studios.
Карачи - портовый город на юге Пакистана, крупнейший город страны и один из крупнейших городов мира, административный центр провинции Синд.
Моя любовь - художественный фильм
Мо-цзы - древнекитайский философ, разработавший учение о всеобщей любви.
Безумный Макс: Дорога ярости - постапокалиптический фильм-боевик австралийского режиссёра Джорджа Миллера, четвёртый фильм о Максе Рокатански.
Артемида - в древнегреческой мифологии всегда юная богиня охоты, богиня плодородия, богиня женского целомудрия, покровительница всего живого на Земле, дающая счастье в браке и помощь при родах, позднее богиня Луны.
Выборг - город в России, административный центр Выборгского муниципального района Ленинградской области.
Типа копы - американская комедия 2014 года режиссёра и сценариста Люка Гринфилда.
Русалка - персонаж славянской мифологии.
Великий перелом - художественный фильм 1945 года. 
Фильм был восстановлен в 1967 году на киностудии Ленфильм.
Чужие - научно-фантастический боевик режиссёра Джеймса Кэмерона, второй из серии кинофильмов о Чужом. 
Входит в «классическую» тетралогию.
Лан Ю - фильм режиссёра Стэнли Квана.
Пэн: Путешествие в Нетландию - приключенческий фэнтези-фильм режиссёра Джо Райта и приквел к одноимённой сказке Джеймса Барри.
Роль Питера Пэна исполнил Леви Миллер.
Ангара - река в Восточной Сибири, самый крупный правый приток Енисея, единственная река, вытекающая из озера Байкал.
1 китайский юань - это примерно 12 российских рублей 8 копеек
1 биткоин - это примерно 418 американских долларов 95 центов
Русалка - мелодрама Анны Меликян 2007 года, романтическая история о девушке Алисе, обладающей уникальными способностями.
Альпы - самый высокий и протяженный горный хребет среди систем, целиком лежащих в Европе.
Элвин и бурундуки: Грандиозное бурундуключение - анимационный фильм, продолжение фильмов «Элвин и бурундуки», «Элвин и бурундуки 2» и «Элвин и бурундуки 3». 
Мировая премьера - 23 декабря 2015 года.
Покахонтас - 33-й полнометражный мультфильм студии Уолта Диснея.
Даша-путешественница - американский обучающий детский сериал.
Рождественское ограбление - семейная комедия режиссёра Дэвида Уинклера 2007 года о неудачнице, провалившей многочисленные ограбления, и давшей себе последний шанс на «исправление» - для этого ей необходимо совершить самое грандиозное из всех ограбление.
Кармелита - российский телесериал, премьера которого состоялась 10 января 2005 года на телеканале «Россия».
Человек за солнцем - гонконгский фильм, повествующий о деятельности японской секретной лаборатории по производству биологического оружия, находившейся на территории Маньчжурии в районе Харбина во время Второй мировой войны.
Белоснежка и семь гномов - американский полнометражный музыкальный фэнтезийный мультипликационный фильм 1937 года производства студии «Walt Disney Productions», снятый по мотивам одноимённой сказки братьев Гримм.
Человек за солнцем - гонконгский фильм, повествующий о деятельности японской секретной лаборатории по производству биологического оружия, находившейся на территории Маньчжурии в районе Харбина во время Второй мировой войны.
Отранто - портовый город на тыльной стороне «каблука» Италии, в провинции Лечче области Апулия.
Премьера состоялась 18 июня 2015 года на кинофестивале в Каннах.
Варендорф - город в Германии, центр одноимённого района, расположен в земле Северный Рейн-Вестфалия.
Агрокомбинат Южный - российская агропромышленная компания.
Оз: Великий и Ужасный - фэнтезийный приключенческий фильм режиссёра Сэма Рэйми, приквел фильма «Волшебник страны Оз» 1939 года.
Курс акций компании Роснефть вырос на 2.09 процента и составил 236 рублей 85 копеек
Хюррем Султан - турецкий исторический телесериал 2003 года.
Ведьмина гора - фильм режиссёра Энди Фикмена, вышедший в марте 2009 года, является ремейком ленты 1975 года «Побег на Ведьмину гору».
Доктор Кто - культовый британский научно-фантастический телесериал компании «Би-би-си» об инопланетном путешественнике во времени, известном как Доктор.
1 американский доллар - это примерно 84 российских рубля 14 копеек
Цена' на нефть марки Brent упала на 1.31 процента, и составила 27 долларов 84 цента за баррель
Плавт - выдающийся римский комедиограф, мастер паллиаты. 
Написал около 52 комедий, из которых сохранилось 20.
Утешение - предстоящий остросюжетный детективный фильм режиссёра Афонсо Пойарта.
Совокупность лжи - кинофильм, драматический боевик режиссёра Ридли Скотта. 
Слоган фильма: «Никому не доверяй. Обмани всех».
Казахстан - государство, располагающееся в центре Евразии, большая часть которого относится к Азии, а меньшая - к Европе.
Конвой - художественный фильм Сэма Пекинпа. 
Премьера состоялась 28 июня 1978 года. 
В СССР показывали в кинотеатрах с дубляжем.
Воскресенск - город в Московской области, административный центр Воскресенского района. 
Численность населения - 93824 чел.
1 российский рубль - это примерно 0.31 украинской гривны
Камеди клаб - российское телевизионное шоу, выходящее с 23 апреля 2005 года на канале ТНТ.
Могучие Рейнджеры Мистическая Сила - это четырнадцатый сезон популярного американского телесериала «Могучие рейнджеры».
1 американский доллар - это примерно 84 российских рубля 14 копеек
Нижнекамск - город в России, третий по численности населения город Татарстана, административный центр Нижнекамского района, крупнейший в России центр нефтехимической промышленности.
ТОНИС - украинский телевизионный канал. 
Начал вещание в 1992 году.
ТОНИС - украинский телевизионный канал.
Начал вещание в 1992 году.
Борис Ельцин - советский партийный и российский политический и государственный деятель, первый президент Российской Федерации.
Орудия смерти: Город костей - фэнтезийный приключенческий фильм 2013 года норвежского режиссёра Харальда Цварта, экранизация первого романа серии «Орудия смерти» Кассандры Клэр.
Эверест - высочайшая вершина Земли.
Карагандинская область - область в центральной части Казахстана, находится в самом центре континента Евразия, почти равноудалена от Северного Ледовитого и Индийского, Атлантического и Тихого океанов.
Женщины в любви - телесериал телекомпании «Глобу» по сценарию бразильского сценариста Маноэла Карлоса.
Хаятэ, боевой дворецкий - японская манга, автором которой является Кэндзиро Хата.
Малкольм в центре внимания - сериал в жанре ситуационной комедии, повествующий о семье среднего класса. 
Цена' на нефть марки Brent упала на 1.31 процента, и составила 27 долларов 84 цента за баррель.
Лента основана на одноимённом короткометражном художественном фильме, созданном Бёртоном на студии «Дисней» в 1984 году.
Орёл и решка - украинская познавательная телепрограмма о путешествиях. 
Премьерный показ и первые трансляции велись на украинском телеканале «Интер».
Бандиты - криминальная комедия Барри Левинсона.
1 американский доллар - это примерно 79 российских рублей 46 копеек
1 американский доллар - это примерно 84 российских рубля 30 копеек
Белая стрела - криминальная драма режиссёра Александра Бурцева.
Производство Intra Film, Россия, 2007 год.
Петрозаводск - город на северо-западе России, столица и самый крупный город Республики Карелия, административный центр Прионежского района.
Чемпионы - спортивная драма Дмитрия Дюжева, Артёма Аксёненко, Алексея Вакулова, Эмиля Никогосяна по мотивам легендарных побед российских 
Веды - сборник самых древних священных писаний индуизма на санскрите.
Яркая звезда - британский кинофильм, основанный на реальных событиях из жизни поэта Джона Китса.
«Сердце Латгалии». 
Город, построенный на семи холмах.
Пётр I - последний царь всея Руси и первый Император Всероссийский.
Пацифида - гипотетический затонувший континент в Тихом океане.
Стерлитамак - город в России, второй по численности населения город Республики Башкортостан, административный центр Стерлитамакского района.
Волгоград - город на юго-востоке европейской части Российской Федерации с населением 1017451 человек.
Собачье сердце - советский двухсерийный чёрно-белый телефильм режиссёра Владимира Бортко, вышедший на киностудии «Ленфильм» в 1988 году.
Лило и Стич - 42-й полнометражный анимационный фильм студии Уолта Диснея, выпущенный в 2002 году. 
С 21 июня он вышел в кинотеатрах Северной Америки.
Шанхайский полдень - фильм режиссёра Тома Дея, комедийный вестерн, рассказывающий о китайце, приехавшем спасать принцессу на Дикий Запад.
Идеальный голос - американская музыкальная комедия режиссёра Джейсона Мура, сценарий к которой написала Кэй Кэннон.
Казахстан - государство, располагающееся в центре Евразии, большая часть которого относится к Азии, а меньшая - к Европе.
Сейшельские Острова - островное государство в Восточной Африке. 
Государство-член Содружества Наций.
Девчата - советский комедийный художественный фильм, снятый в 1961 году режиссёром Юрием Чулюкиным по одноимённой повести Бориса Бедного.
Тор - художественный фильм режиссёра Кеннета Брана, основанный на одноимённых комиксах издательства Marvel Comics.
Премьера фильма состоялась 7 декабря 2004 года.
Парк Юрского периода 3 - американский научно-фантастический и приключенческий фильм, являющийся третьим в серии «Парк юрского периода».
Американская история ужасов - американский телесериал-антология в жанре хоррор-триллера, созданный и спродюсированный Райаном Мёрфи и Брэдом Фэлчаком.
Улыбка пересмешника - российский шестнадцатисерийный остросюжетный драматический телевизионный художественный фильм режиссёра Алексея Рудакова, снятый в 2014 году.
Джек-потрошитель - псевдоним, присвоенный серийному убийце, который действовал в Уайтчепеле и прилегающих районах Лондона во второй половине 1888 года.
Тернополь - город на Украине, политико-административный, экономико-деловой и культурный центр Тернопольской области.
Карлан - район в Португалии, входит в округ Вила-Реал.
Является составной частью муниципалитета Алижо.
Синоптик - американская драма 2005 года режиссёра Гора Вербински с Николасом Кейджем в главной роли.
Аватар: Легенда об Аанге - американский анимационный телесериал, созданный Майклом Данте Димартино и Брайаном Кониецко, которые выступали также в качестве исполнительных продюсеров наряду с Аароном Эхазом.
Фонограмма страсти - романтический триллер режиссёра Николая Лебедева.
Теория Большого взрыва - американский ситком, созданный Чаком Лорри и Биллом Прэди. 
Премьера состоялась 24 сентября 2007 года на канале CBS.
Женщина в чёрном - мистический фильм, снятый по одноимённому роману английской писательницы Сьюзен Хилл
В главной роли - Дэниел Рэдклифф.
Ключ от всех дверей - американский мистический триллер 2005 года британского режиссёра Иэна Софтли. 
Премьера фильма состоялась 29 июля 2005 года.
Входит в состав Кировско-Выборгской линии, расположена между станциями «Площадь Мужества» и «Академическая».
Дилижан - город в Тавушской области Армении, горноклиматический и бальнеологический курорт.
Расположен на реке Агстев.
Сценарий фильма основан на одноимённой серии книг Роберта Стайна.
На измене - российский художественный фильм режиссёра Александра Атанесяна по мотивам пьесы Рэя Куни «Не обслуживается»
Побег из Шоушенка - американский художественный фильм-драма 1994 года, снятый режиссёром Фрэнком Дарабонтом по повести Стивена Кинга «Рита Хейуорт и спасение из Шоушенка».
Блеск - австралийская биографическая драма 1996 года о пианисте Дэвиде Хельфготте.
Премьера фильма состоялась в январе 1996 года на кинофестивале «Сандэнс».
1 американский доллар - это 20461 белорусский рубль
1 российский рубль - это примерно 1 цент
Чингисхан - основатель и первый великий хан Монгольской империи, объединивший разрозненные монгольские племена; полководец, организовавший завоевательные походы монголов в Китай, Среднюю Азию, на Кавказ и Восточную Европу.
Анатомия страсти - американский телесериал, созданный Шондой Раймс.
Ташкент - столица Республики Узбекистан, город республиканского подчинения, административный центр Ташкентской области, в состав которой не входит.
Фантастическая четвёрка - художественный фильм о супергероях режиссёра Джоша Транка, основанный на комиксах об одноимённой команде, созданной Marvel Comics.
Следы Апостолов - телевизионный художественный фильм.
Смертельный лабиринт - триллер 2005 года режиссёра Стивена Монро. 
Премьера фильма состоялась 20 мая 2004 года.
Маша и Медведь - российский мультипликационный сериал, созданный российской анимационной студией «Анимаккорд», ориентированный на общую аудиторию, показ начался с 7 января 2009 года.
Закрытая Школа - российский телесериал в жанре мистического триллера с элементом драмы.
Иркутск - город в России. 
Административный центр Иркутской области и Иркутского района, образует Иркутский городской округ.
Рокки Бальбоа - художественный фильм, снятый режиссёром Сильвестром Сталлоне, который является автором сценария и исполняет главную роль.
Запрещённая реальность - кинофильм в жанре фантастического боевика, дебютная режиссёрская работа Константина Максимова, экранизация романа Василия Головачёва «Смерш 2».
Снупи и мелочь пузатая в кино - предстоящий компьютерно-анимационный фильм, основанный на комиксах «Peanuts», а также пятый полнометражный мультфильм по мотивам этих комиксов.
Подранки - советский художественный фильм режиссёра Николая Губенко, вышедший на киностудии «Мосфильм» в 1976 году.
Милашка в розовом - американская романтическая комедия 1986 года.
Мертвый омут - триллер Филлипа Нойса по Мёртвый омут Уильямс, Чарльз. Кинопремия Австралии.
Титаник - фильм-катастрофа 1997 года, снятый режиссёром Джеймсом Кэмероном, в котором показана гибель легендарного лайнера «Титаник».
Няньки - кинокомедия 1994 года автора сценария и режиссёра Джона Парагона с Питером Полом, Дэвидом Полом, Кристианом Казинсом и Джозефом Казинсом в главных ролях.	имена
Волки - фильм ужасов об оборотнях режиссёра и сценариста Дэвида Хейтера, его режиссёрский дебют.	Хейтера
Парк юрского периода: Затерянный мир - фильм режиссёра Стивена Спилберга по роману «Затерянный мир» Майкла Крайтона.
Цена' на нефть марки Brent упала на 1.31 процента, и составила 27 долларов 84 цента за баррель
Мультфильм вышел на экраны 20 мая 2010 года.
Атлантида - мифический остров-государство.
Барбакан - фортификационное сооружение, предназначенное для дополнительной защиты входа в крепость.
Кьявари - коммуна в Италии, располагается в регионе Лигурия, в провинции Генуя.
С 16 декабря 2011 года министр финансов Российской Федерации.
Катманду - столица и крупнейший город Непала, его исторический, экономический, политический и культурный центр.
Лима - город и столица республики Перу. 
Административный центр автономной провинции Лима региона Лима.
Премьера в США состоялась 29 сентября 2012 года на канале Nickelodeon.
Призрачный гонщик - фильм 2007 года, основанный на истории о персонаже «Призрачный гонщик» из вселенной Marvel Comics.
Универ. 
Новая общага - сериал-ситком, повествующий о жизни студентов, проживающих в одном блоке общежития. 
Одно из продолжений телесериала «Универ».
Фильм двухсерийный.
1500 российских рублей - это примерно 17 американских долларов 65 центов
Нечаянно - российский короткометражный фильм режиссёра и сценариста Жоры Крыжовникова в жанре новогодней чёрной комедии.
Билайн - В частности, под этой маркой оказываются услуги сотовой и фиксированной связи, проводного и беспроводного высокоскоростного доступа в Интернет, IP-телевидения.
Звонок - ремейк японского фильма ужасов «Звонок», снятый режиссёром Гором Вербински.
Килис - город и район в провинции Килис, административный центр провинции.
Школа мертвецов - манга, созданная Дайсукэ и Сёдзи.
Патриот - драматический кинофильм Роланда Эммериха на тему войны за независимость Соединённых Штатов.
Лофт - триллер бельгийского режиссёра Эрика Ван Лоя, американский ремейк одноимённого фильма, поставленного им же в 2008 году.
Джеки Браун - криминальная драма режиссёра Квентина Тарантино, премьера которой состоялась в 1997 году, экранизация романа «Ромовый пунш» Элмора Леонарда.
Китоврас - мифическое существо, упоминаемое в древнерусских апокрифах с XIV века
Молдова - государство в Юго-Восточной Европе. Граничит с Украиной и Румынией.
Рататуй - американский полнометражный анимационный фильм, комедия режиссёра Брэда Бёрда. Восьмой полнометражный фильм, созданный на студии Pixar.
Цена' на нефть марки Brent упала на 2.27 процента, и составила 27 долларов 57 центов за баррель
Призрак - фильм российского режиссёра Александра Войтинского, вышедший на экраны 26 марта 2015 года.
Майор Пэйн - кинокомедия 1995 года.
Курс акций компании Сбербанк вырос на 0.73 процента и составил 84 рубля 61 копейка
Наволоки - город районного подчинения в Кинешемском районе Ивановской области России, административный центр Наволокского городского поселения.
1 евро - это примерно 87 российских рублей 3 копейки
Правдивая ложь - комедийный боевик режиссёра Джеймса Кэмерона, ремейк французской комедии «Тотальная слежка».
Посланник - драма режиссёра Орена Мовермана, вышедшая на экраны в 2009 году.
Выживший - американский вестерн-триллер 2015 года режиссёра Алехандро Гонсалеса Иньярриту.
Их двое - фильм 1977 года, мелодрама. Франция, Венгрия.
1 украинская гривна - это примерно 0.99 чешской кроны
Эксперимент - американский психологический триллер 2010 года.
Ротшильды - европейская династия банкиров и общественных деятелей еврейского происхождения, чья история восходит к концу XVIII века.
Грифоны - мифологические крылатые существа, с туловищем льва, головой орла. 
Имеют острые когти и белоснежные или золотые крылья.
1 чешская крона - это примерно 4 евроцента
Калигула - эпический антитоталитарный кинофильм Тинто Брасса о нравах времён правления древнеримского императора Калигулы, вошедшего в историю беспримерной жестокостью, коварством и пороками.
Люди в чёрном 3 - американская научно-фантастическая комедия, продолжение фильма «Люди в чёрном 2» 2002 года.
1 дюйм - это 2.54 сантиметра
1 американский доллар - это 20461 белорусский рубль
Дом страха - американский фильм ужасов\триллер 2004 года режиссёра Билла Батлера. 
Премьера фильма состоялась 30 июля 2004 года.
Ай-Петри - гора в Крымских горах в составе массива Ай-Петринская яйла.
Дракула - дебютный фильм режиссёра Гари Шора по сценарию Мэтта Сазамы и Берка Шарплесса, рассказывающий историю происхождения Дракулы.
Кинг Конг - приключенческий фильм 2005 года, ремейк одноимённого фильма 1933 года.
Иран - государство в Передней Азии. Столица - город Тегеран.
Гуси-лебеди - русская народная сказка.
Операция «Ы» и другие приключения Шурика - советский комедийный художественный фильм, снятый в 1965 году режиссёром Леонидом Гайдаем.
Тимати - российский исполнитель, музыкальный продюсер, актёр и предприниматель, выпускник «Фабрики звёзд 4». 
Заслуженный артист Чеченской Республики.
Святой - американский художественный фильм 1997 года.
Свадьба в Малиновке - музыкальная комедия Андрея Тутышкина, экранизация одноимённой оперетты народного артиста СССР Бориса Александрова. 
Сабрина - маленькая ведьма - американский телесериал, ситуационная комедия о девушке по имени Сабрина, ставшей в свой шестнадцатый день рождения ведьмой.
Шлагбаум - устройство для быстрого преграждения и освобождения пути в виде поворачивающейся вокруг горизонтальной или вертикальной оси стрелы.
Самарканд - второй по величине город Узбекистана, административный центр Самаркандской области.
Исламабад - столица Исламской Республики Пакистан. 
Культурный, политический и экономический центр страны.
Выжить любой ценой - приключенческая передача на канале «Discovery Channel», в которой ведущий Беар Гриллс высаживается во всевозможных диких местах и показывает зрителям, как выжить и найти помощь.
Миссия невыполнима: Протокол Фантом - приключенческий боевик режиссёра Брэда Бёрда, продолжение фильма «Миссия невыполнима 3» и четвёртая по счёту часть киносериала «Миссия невыполнима».
Звёздные врата: Континуум - художественный фильм, основанный на популярном научно-фантастическом телесериале «Звёздные врата. SG-1»
Тампа - третий по размеру город штата Флорида, административный центр округа Хиллсборо, находящийся на западе полуострова, на побережье залива Тампа.
Население - 409285 чел.
1 американский доллар - это примерно 84 российских рубля 20 копеек
Разград - город в Болгарии, в исторической области Лудогорие. 
Находится в Разградской области, входит в общину Разград.
Астрал: Глава 2 - фильм ужасов 2013 года, снятый Джеймсом Ваном. Актёрский состав фильма тот же, что и в предыдущей части, но появились и новые актёры.
Сиквел фильма «Я плюю на ваши могилы».
Бёрдмэн - американская чёрная кинокомедия режиссёра Алехандро Гонсалеса Иньярриту с Майклом Китоном в главной роли.
Стрела - американский приключенческо-супергеройский телесериал с элементами драмы, основанный на комиксах о супергерое DC Comics Зелёная стрела.
Кобрин - город в Брестской области Республики Беларусь, административный центр Кобринского района.
Когда расходится туман - советский драматический приключенческий фильм 1970 года.
Новые приключения Золушки - кинофильм режиссёра Пола Болджера. Это анимационный фильм по мотивам сказок Братьев Гримм. 
Создан в 2007 году.
Двадцать одно - американский фильм-драма, снятый режиссёром Робертом Лукетичем по роману Бена Мезрича, написанному в 2003 году, - «Удар по казино. Как сорвать куш: Реальная история шести студентов, обыгравших Лас-Вегас на миллионы долларов».
643 американских доллара - это примерно 54643 российских рубля 43 копейки
Бурятия - субъект Российской Федерации. Входит в состав Сибирского федерального округа.
Карты, деньги, два ствола - художественный фильм, чёрная комедия 1998 года.
Я тебя никогда не забуду - советский полнометражный цветной художественный фильм, поставленный на Киностудии «Ленфильм» в 1983 году режиссёром Павлом Кадочниковым.
Смертельная гонка - кинофильм, фантастический боевик.
Обливион - фантастический боевик режиссёра Джозефа Косински по одноимённому неопубликованному графическому роману.
Гадкий я 2 - компьютерный мультфильм, сиквел комедийного мультфильма «Гадкий я». Премьера состоялась 16 июня 2013 года, в России 15 августа 2013 года.
1 российский рубль - это примерно 257.3 белорусского рубля
1 российский рубль - это примерно 1 цент
Звенигово - город в России, административный центр Звениговского района Марий Эл и одноимённого городского поселения.
Щигры - город в Курской области России.
Сортавала - город в Российской Федерации, в Республике Карелия, административный центр Сортавальского городского поселения и Сортавальского района.
Морская Полиция: Лос-Анджелес - американский телесериал, сочетающий в себе элементы военной драмы и детектива, премьера которого состоялась на CBS 22 сентября 2009 года.
Майма - село в Республике Алтай России, административный центр Майминского муниципального района и Майминского сельского поселения.
Атрибут - веер из хвоста павлина.
Идеальный побег - триллер Дэвида Туи, вышедший в российский кинопрокат 3 сентября 2009 года.
1 американский доллар - это примерно 84 российских рубля 5 копеек
1 американский доллар - это примерно 84 российских рубля 5 копеек
Бьютифул - драматический фильм 2010 года режиссёра Алехандро Гонсалеса Иньярриту. Участник основного конкурса Каннского кинофестиваля 2010 года.
Алиса в Стране чудес - 13-й анимационный фильм компании Уолта Диснея, созданный в 1951 году. Считается культовым.
Глоссарий - словарь узкоспециализированных терминов в какой-либо отрасли знаний с толкованием, иногда переводом на другой язык, комментариями и примерами.
Программа защиты принцесс - американский комедийный фильм 2009 года, выпущенный студией Дисней в рамках рубрики «Оригинальное кино канала Дисней».
Penthouse - эротический развлекательный журнал для мужчин, один из самых известных в мире брендов.
Финляндия - государство на севере Европы. Население по оценкам на 2015 год составляет около 5 479 800 человек, территория - 338 430,53 км².
Рубикон - небольшая река на Апеннинском полуострове, впадает в Адриатическое море, к северу от Римини.
Распутник - эксцентрическая комедия 2000 года французского режиссёра Габриэля Агийона.
Стюарт Литтл - фильм режиссёра Роба Минкоффа по одноименному произведению Элвина Брукса Уайта.
Топки - город в России, тринадцатый по численности населения и шестнадцатый по площади город в Кемеровской области.
Азербайджан - государство на Южном Кавказе, расположенное в Передней Азии, а также по мнению некоторых источников, частично и в Восточной Европе.
Люди в чёрном 3 - американская научно-фантастическая комедия, продолжение фильма «Люди в чёрном 2» 2002 года.
1 американский доллар - это примерно 84 российских рубля 20 копеек
10 причин моей ненависти - художественный фильм. Вольная экранизация пьесы Уильяма Шекспира «Укрощение строптивой».
 Леон - фильм французского режиссёра Люка Бессона, вышедший на экраны в 1994 году. Снят по собственному сценарию Бессона.
Реальные пацаны - американский комедийный сериал, показываемый по каналу Spike с начала 2010 года. В России был показан по MTV
После ряда военных успехов Ашока подчинил себе значительную часть Южной Азии от современного Афганистана до Бенгалии и далее на юг до Майсура.
Фильм считается классикой советской комедии.
1 американский доллар - это примерно 84 российских рубля 20 копеек
 Импорт-экспорт - фильм австрийского режиссёра Ульриха Зайдля, 2007 года. Картина была номинирована на Золотую пальмовую ветвь Каннского кинофестиваля 2007 года.
ТриМоб - общество с ограниченной ответственностью, национальный оператор мобильной связи.
 Квант милосердия - двадцать второй фильм из серии фильмов EON Productions об английском агенте Джеймсе Бонде, герое романов Яна Флеминга.	EON
Барвиха - посёлок в Одинцовском районе Московской области, расположенный неподалёку от Рублёво-Успенского шоссе на реке Самынке.
BIOS - набор микропрограмм, реализующих API для работы с аппаратурой компьютера и подключёнными к нему устройствами.
Благовещенск - город в России. 
Административный центр Амурской области и Благовещенского района, образует «Городской округ город Благовещенск».
Россия-24 - российский федеральный государственный информационный телеканал.
Викинги - канадо-ирландская историческая драма, созданная Майклом Хёрстом специально для телеканала History, премьера которой состоялась 3 марта 2013 года.
Воздушные замки - бразильский телесериал.
Назарет - город в Галилее, на севере Израиля. Это священный христианский город, третий по значимости после Иерусалима и Вифлеема.
Шрек 2 - компьютерный полнометражный анимационный фильм киностудии Dreamworks Pictures 2004 года, который является продолжением фильма «Шрек».
Уфа - один из крупнейших городов Российской Федерации, столица Республики Башкортостан, административный центр городского округа город Уфа и Уфимского муниципального района.
Красноярск - деревообрабатывающие, строительных материалов.
Беовульф - англосаксонская эпическая поэма, действие которой происходит в Скандинавии до переселения англов в Британию.
Названа по имени главного героя.
Бегущий в лабиринте: Испытание огнём - американский фильм 2015 года режиссёра Уэса Болла. 
Сиквел фильма 2014 года «Бегущий в лабиринте».
Банско - город в юго-западной Болгарии, в Благоевградской области.
Хроники Нарнии: Серебряное кресло - экранизация романа «Серебряное кресло», четвёртой книги из серии писателя и телеведущего Клайва Льюиса «Хроники Нарнии»; продолжение фильма «Хроники Нарнии: Покоритель зари».
Киев - столица и крупнейший город Украины, Город-Герой. Расположен на реке Днепр, центр Киевской агломерации.
Джек – покоритель великанов - фэнтезийный приключенческий фильм режиссёра Брайана Сингера по мотивам сказок «Джек - убийца великанов» и «Джек и бобовый стебель».
Планета 51 - мультфильм Хорхе Бланко. Сценарий мультфильма написал Джо Стиллман.
Волчонок - молодёжный мистико-драматический телесериал, снятый в США по мотивам одноимённого фильма 1985 года по заказу канала MTV.
Кыштым - город областного подчинения в Челябинской области России. Население - 38008 человек.
Datsun - японская автомобильная компания, существовавшая в XX веке, и марка японских автомобилей, производившихся с 1931 по 1986 год.
Эверест - высочайшая вершина Земли.
Пестово - город в России, административный центр Пестовского района Новгородской области.
Лонгйир - крупнейший населённый пункт и административный центр норвежской провинции Свальбард.
Китай - социалистическое (коммунистическое) государство в Восточной Азии.
Череповец - город в России, административный центр Череповецкого района, первый по численности населения город Вологодской области. Население - 318107 чел.
Страбон - греческий историк и географ.
Премьера состоялась в 1992 году.
Левиафан - киноинтерпретация истории библейского персонажа Иова, поставленная режиссёром Андреем Звягинцевым в условиях современной России.
Город героев - американский трёхмерный компьютерный анимационный фильм 2014 года, созданный студией «Walt Disney Animation Studios» и выпущенный кинокомпанией «Walt Disney Pictures».
Следствие вели... - авторский цикл документальных передач телеканала НТВ о самых громких преступлениях, совершённых в СССР.
Спортлото-82 - советский художественный фильм, снятый в 1982 году режиссёром Леонидом Гайдаем по мотивам одноимённой всесоюзной тиражной лотереи спортлото.
Варадеро - курортный город в провинции Матансас на Кубе. Расположен на полуострове Икакос, в 140 км к востоку от Гаваны.
Каламбур - развлекательный телевизионный журнал видеокомиксов. Впервые вышел на экраны 12 октября 1996 года на канале ОРТ.
Крысятник - первый полнометражный фильм французского сценариста и кинорежиссера Франсуа Озона.
Константинополь - название Стамбула с 1453 до 1930 года, неофициальное название столицы Римской империи, Византийской, или Восточно-Римской империи, Латинской империи и Османской империи.
Плохие - британский трагикомедийно-фантастический телесериал. Премьера состоялась 12 ноября 2009 года на канале E4.
Перси Джексон и Море чудовищ - художественный фильм режиссера Тора Фройденталя, экранизация романа «Море чудовищ», писателя Рика Риордана.
Тюдоры - британско-ирландско-канадский исторический телесериал Майкла Хёрста, действие которого разворачивается в Англии в шестнадцатом веке.
Счастливы вместе - комедийный сериал, российская версия американского сериала «Женаты… с детьми», транслировался на российском телеканале ТНТ и украинском «Новом канале».
Доктор - кинофильм.
Украина - государство в Восточной Европе.
Брянск - город в Российской Федерации, административный центр Брянской области.
Тхэквондо - корейское боевое искусство. Характерная особенность тхэквондо - активное использование ног в бою, причем как для ударов, так и для блоков.
Фильм основан на более ранней версии 1968 года.
28 дней спустя - британский фильм ужасов режиссёра Дэнни Бойла. В главных ролях снимались Киллиан Мёрфи и Наоми Харрис.
Звёздные войны: Эпизод 4 - Новая надежда - эпический научно-фантастический фильм 1977 года, снятый Джорджем Лукасом.
Столкновение - драма режиссёра Пола Хаггиса, которая была представлена публике на кинофестивале в Торонто в сентябре 2004 года, а в 2005 году фильм был выпущен в международный прокат.
Шафер напрокат - американская комедийная кинолента, режиссёром которой предстал Джереми Гарелик.
1 евро - это примерно 27.11 украинской гривны
Секс по дружбе - романтическая комедия 2011 года о том, как непросто найти похожую на тебя вторую половину и как удержать отношения, когда созданы все условия для их развития.
Гуппи и пузырики - детский американский анимационный мультсериал в стиле музыкальной комедии для детей дошкольного возраста.
Братцево - исторический район в Москве на территории районов Южное Тушино и Северное Тушино, ранее - загородная усадьба, до 1980 года также село на северо-западе Москвы.
007: Координаты «Скайфолл», Умри, но не сейчас, Золотой глаз , и другие фильмы про шпионов
Унесённые призраками - полнометражный аниме-фильм режиссёра Хаяо Миядзаки, который был снят на студии «Гибли» в 2001 году.
Возмездие - художественный фильм в жанре триллера, снятый по мотивам одноимённого телесериала 1985 года производства «BBC».
007: Спектр - двадцать четвёртый фильм из серии фильмов про британского агента Джеймса Бонда, героя романов Яна Флеминга.
 Пираты Карибского моря: На краю Света - кинофильм и третья часть приключенческо-комедийного цикла, выполненного в эпическом жанре. Год создания - 2007.
Цена' на нефть марки Brent упала на 1.31 процента, и составила 27 долларов 84 цента за баррель
Мозаика - декоративно-прикладное и монументальное искусство разных жанров, произведения которого подразумевают формирование изображения посредством компоновки, набора и закрепления на поверхности разноцветных камней, смальты, керамических плиток и других материалов.
Доспехи Бога - гонконгский приключенческий кинофильм с боевыми искусствами, снятый Джеки Чаном, который также исполнил главную роль.
Лексика - совокупность слов того или иного языка, части языка или слов, которые знает тот или иной человек или группа людей.
Холодное сердце - компьютерный анимационный фильм 2013 года, пятьдесят третий полнометражный мультфильм, созданный студией «Walt Disney Animation Studios» и выпущенный компанией «Walt Disney Pictures».
Воздушная тюрьма - кинофильм 1997 года производства США.
Алтайский край - субъект Российской Федерации, входит в состав Сибирского федерального округа.
Образован 28 сентября 1937 года. Административный центр - Барнаул.
Я стесняюсь своего тела - телевизионный медицинский проект на канале СТБ.
Барашек Шон - серия коротких анимационных фильмов о жизни отары овец, вожаком которой является барашек по имени Шон.
Ширли-Мырли - комедия-фарс Владимира Меньшова, яркий представитель российского кино 1990-х годов.
Омерзительная восьмёрка - предстоящий вестерн режиссёра и сценариста Квентина Тарантино.
mts - российская телекоммуникационная компания, оказывающая услуги в России и странах СНГ под торговой маркой «МТС».
Штаны - советский художественный фильм 1988 года.
Первый мститель: Противостояние - предстоящий супергеройский боевик братьев Энтони и Джо Руссо и производства Marvel Studios.
Монстры - фантастический фильм режиссёра Гарета Эдвардса. В российском прокате с 30 сентября 2010 года.
Киноадаптация одноимённого романа Чак Логана.
Легенды осени - кинофильм. Экранизация произведения.
Цена' на Золото упала на 0.33 процента, и составила 1097 долларов 90 центов за тройскую унцию
Толедо - город в центральной части Испании, столица провинции Толедо и автономного сообщества Кастилия - Ла-Манча
Шотландия - страна, являющаяся частью Соединённого Королевства Великобритании и Северной Ирландии.
Скорпион - восьмой знак зодиака, соответствующий сектору эклиптики от 210° до 240°, считая от точки весеннего равноденствия; постоянный знак. Стихия - Вода
О, женщины! - эротический художественный фильм Тинто Брасса с элементами комедии.
Джо Кокер - британский певец, работавший в жанрах блюз и рок.
Офицер ордена Британской империи.
Ростов-на-Дону - крупнейший город на юге Российской Федерации, административный центр Ростовской области и Южного федерального округа.
Город воинской славы.
Ryanair - ирландская авиакомпания, крупнейшая бюджетная авиакомпания в Европе.
Штаб-квартира - Сордс, графство Дублин.
Мармарик - река, протекающая в Армении, на севера Котайкской области, является правым притоком реки Раздан.
Неуместный человек - притча норвежского режиссёра Йенса Лиена.	лиёна имена
Лауреат национальных кинопремий и призов международных кинофестивалей в жанре фантастических фильмов.
Аполлон - Аполлон - в древнегреческой мифологии златокудрый сребролукий бог света, покровитель искусств, предводитель и покровитель муз, предсказатель будущего, бог-врачеватель, также очищал людей, совершавших убийство.
Поп - российский исторический художественный фильм режиссёра Владимира Хотиненко.
1 американский доллар - это 24.75 украинской гривны
Улан-Удэ - город в Восточной Сибири, столица Республики Бурятия. Образует городской округ город Улан-Удэ.
Парижский мирный договор - международный договор, подписанный 18 марта 1856 года на Парижском конгрессе, открывшемся 13 февраля 1856 года в столице Франции.
Иордания - арабское государство на Ближнем Востоке.
Нарко - американский телесериал, выпущенный студией Netflix 28 августа 2015 года.
Маленькое королевство - британский мультсериал производства мультипликационной студии Peppa Pig для детей дошкольного возраста, выпущенный в эфир в 2009 году и завоевавший популярность как среди детей, так и среди взрослых.
Курс акций компании ГАЗПРОМ вырос на 1.27 процента и составил 127 рублей 10 копеек
Бабур - тимуридский правитель Индии и Афганистана, полководец, основатель империи Великих Моголов.
Известен также как поэт и писатель.
Бой с тенью 2: Реванш - российский художественный фильм 2007 года, продолжение фильма «Бой с тенью».
Лапландия - название расположенного в Северной Европе культурного региона, который традиционно населяют саамы.
Человек, который плакал - фильм режиссёра Салли Поттер, снятый в 2000 году.
Как стать принцессой - кинофильм, снятый в 2001 году американским режиссёром Гарри Маршаллом, автором популярных лент «Красотка», «Сбежавшая невеста».провинции Бергамо.
Бедная Саша - лирическая Новогодняя комедия Тиграна Кеосаяна с участием Александра Збруева и Веры Глаголевой.
Мстители: Величайшие герои Земли - американский мультсериал, разработанный компанией Marvel Animation, основан на комиксах о команде супергероев под названием "Мстители".
Закон каменных джунглей - российский криминальный телесериал производства кинокомпании «RatPack» по заказу телеканала ТНТ.
Пилотное название сериала - «Каменные джунгли».
Станислав Говорухин - советский и российский кинорежиссёр, сценарист, актёр, заслуженный деятель искусств Украинской ССР, народный артист Российской Федерации.
Великолепный век - турецкий исторический телесериал в жанре остросюжетной драмы.
На экранах с 5 января 2011 года.
Барби - изначально детская игрушка, преимущественно для девочек 3-14 лет. Была впервые выпущена в 1959 году в США в штате Висконсин.
IMAX - широкоформатная кинематографическая система, на которой основаны ряд технологий кинопоказа и устройство сети кинотеатров по всему миру.
Калининск - город в России, административный центр Калининского района, Саратовской области, город областного подчинения.
1 белорусский рубль - это примерно 0.00389 российского рубля
1 американский доллар - это примерно 84 российских рубля 98 копеек
Анжи - российский футбольный клуб из города Махачкалы, выступающий в Премьер-Лиге.
Основан в 1991 году.
Люди Икс: Апокалипсис - предстоящий фантастический боевик режиссёра Брайана Сингера, рассказывающий о приключениях одноимённой команды супергероев из комиксов Marvel.
Господа офицеры: Спасти императора - приключенческий художественный фильм Олега Фомина.
Япония - островное государство в Восточной Азии.
Три богатыря: Ход конем - 10-й полнометражный анимационный фильм студии «Мельница».
Том и Джерри в детстве - мультсериал, рассказывающий о приключениях Тома и Джерри в детстве.
Дербент - город на юге России в Республике Дагестан на узком проходе между Каспийским морем и предгорьем Кавказа.
Курс акций компании ГАЗПРОМ вырос на 1.16 процента и составил 126 рублей 96 копеек
1 гигабайт - это 1024 мегабайта
Москва-Сити - строящийся деловой район в Москве на Пресненской набережной.
Широко шагая 2: Расплата - продолжение боевика «Широко шагая».
Бэйб: Поросёнок в городе - австралийский детский комедийный фильм 1998 года.
Лента снята путём совмещения живых актёров и анимации.
Дивергент, глава 2: Инсургент - фильм режиссёра Роберта Швентке по роману Вероники Рот «Инсургент».
90000 американских долларов - это 7648380 российских рублей
Обитель лжи - американский трагикомедийный телесериал, рассказывающий о жизни и работе консалтинговых менеджеров.
Битлджус - мистический фильм ужасов режиссёра Тима Бёртона.
Премия «Оскар» за «Лучший грим».
Как выйти замуж за миллионера - американский кинофильм 1953 года.
«Первый канал» присвоил фильму возрастной рейтинг 12+.
Ярославский вокзал - Ярославский вокзал - пассажирский терминал станции Москва-Пассажирская-Ярославская, один из девяти железнодорожных вокзалов Москвы, крупнейший по объёму перевозок пассажиров, ежесуточно обслуживающий около 300 пар поездов.
Железный человек 2 - фантастический боевик, продолжение фильма «Железный человек» 2008 года, основанного на комиксах студии Marvel.
1 евро - это примерно 1 американский доллар 9 центов
Является бывшей колонией Великобритании, получила независимость 12 декабря 1963 года. Входит в Содружество наций.
Пиковая дама: Чёрный обряд - российский фильм ужасов режиссера Святослава Подгаевского 2015 года.
Из машины - британский научно-фантастический фильм 2015 года, написанный и срежиссированный Алексом Гарлендом, и ставший его режиссёрским дебютом.
Административный центр Архызского сельского поселения.
Репруа - река в Гагрском районе Абхазии, имеющая наибольшее основание претендовать на звание самой короткой реки в мире.
Однажды в сказке - американский телесериал канала ABC в жанре фэнтези.
Премьера состоялась 23 октября 2011 года.
Херцег-Нови - город в Черногории.
Город лежит в долине у подножия горы Орьен.
Механик - фильм Саймона Уэста, ремейк одноимённого фильма 1972 года, в котором снялся Чарльз Бронсон.
Любовь и страсть - фильм классика эротического кино, режиссёра Тинто Брасса.
Армагеддон - американский фантастический фильм 1998 года режиссёра Майкла Бэя.
Карсун - посёлок городского типа в России, административный центр Карсунского района Ульяновской области.
Днепр - третья по длине и площади бассейна река Европы после Волги, Дуная, имеет самое длинное русло в границах Украины.
Атланта - город в США, столица и крупнейший город в штате Джорджия, административный центр округа Фултон.
Арзамас - город в России, в Нижегородской области, является муниципальным образованием, наделённым статусом городского округа.
Глухарь - российский телевизионный сериал, транслировавшийся на телеканале НТВ с 24 ноября 2008 года по 28 октября 2011 года.
Первая модель, выпущенная на Волжском автомобильном заводе.
Груз 200 - одиннадцатый фильм режиссёра Алексея Балабанова, снятый в 2007 году.
Голливудские копы - комедийный боевик 2003 года режиссёра Рона Шелтона, в главных ролях Харрисон Форд и Джош Хартнетт.
Обратный отсчёт - российский кинофильм 2006 года.
Фильм является экранизацией одноимённого романа Николаса Спаркса.
1 китайский юань - это примерно 12 российских рублей 8 копеек
Феи: Потерянное сокровище - полнометражный компьютерный мультфильм 2009 года, выпущенный компанией DisneyToon Studios на основе бренда Disney Fairies.
Битва за Севастополь - историческая драма, украинско-российский полнометражный биографический фильм о советском снайпере Людмиле Павличенко.
Король воздуха - американская кинокомедия режиссёра Чарльза Мартина Смита.
Последняя любовь на Земле - фантастическая мелодрама британского режиссёра Дэвида Маккензи.
Главные роли в фильме исполнили Юэн Макгрегор и Ева Грин.
Съёмки проходили в Глазго.
Камасутра - древнеиндийский трактат, посвящённый теме камы - сферы чувственной, эмоциональной жизни, вожделения и любви.
Как назвать эту любовь? - индийский телесериал, пародия на мыльные оперы, транслировавшаяся по телеканалу Star Plus.
Эффект бабочки - американский фильм 2004 года.
Сценарий основан на понятии эффекта бабочки из теории хаоса.
Россия-24 - российский федеральный государственный информационный телеканал.
Мыслить как преступник - американский телесериал о работе команды лучших следователей ФБР, способных понять и проанализировать ход мыслей самых изощрённых преступников, предугадать их дальнейшие поступки и тем самым предотвратить ужасные преступления.
Битва Титанов - художественный фильм Луи Летерье, ремейк одноимённого фильма 1981 года, в основе сюжета которого лежит древнегреческий миф о Персее.
Земля любви - бразильский сериал о жизни итальянских эмигрантов в Бразилии в конце XIX века.
Марк Туллий Цицерон - древнеримский политический деятель, оратор и философ.
Проклятие - фильм ужасов 2004 года.
Является ремейком японского фильма Дзю-он: Проклятие.
Юрий Чайка - Генеральный прокурор Российской Федерации с 23 июня 2006 года.
Ульяновск - являвшегося уроженцем Симбирска.
УАЗ-452 - автомобиль, производимый на Ульяновском автомобильном заводе. 
Серийный выпуск УАЗ-452 начат в 1965 году.
Двигатель - вариант двигателя ГАЗ-21.
Последняя роль в кино российского актёра Андрея Краско.
1 американский доллар - это примерно 83 российских рубля 59 копеек
1 британский фунт - это примерно 112 российских рублей 50 копеек
Италия - государство в Южной Европе, в центре Средиземноморья.
Все леди делают это - эротический фильм режиссёра Тинто Брасса.
180 украинских гривен - это примерно 577 российских рублей 90 копеек
TeamViewer - пакет программного обеспечения для удалённого контроля компьютеров, обмена файлами между управляющей и управляемой машинами, видеосвязи и веб-конференций.
Остановка по требованию - российский сериал 2000 года.
Брейниак - вымышленный персонаж, суперзлодей из комиксов издаваемых DC Comics, впервые появившийся в Action Comics № 242.
Киев - столица и крупнейший город Украины, Город-Герой.
Расположен на реке Днепр, центр Киевской агломерации.
Новокузнецк - крупный город в Кемеровской области России, административный центр Новокузнецкого муниципального района Кемеровской области, образует городской округ «город Новокузнецк».
Был объявлен Hasbro в рамках пресс-кит на «Европейской международной ярмарке игрушек 2014».
Белый Ветер Цифровой - российская компания, работавшая в области розничной торговли и электронной коммерции с 1991 по 2014 год.
Красотка - художественный фильм, снятый в жанре любовной истории.
Малаховка - посёлок городского типа в Люберецком районе Московской области России; крупнейший населённый пункт муниципального образования «Городское поселение Малаховка».
Камбоджа - государство в Юго-Восточной Азии, на юге полуострова Индокитай, со столицей Пномпень. 
Мак-Кинли - двуглавая гора на Аляске, высочайшая гора Северной Америки.
Тор 2: Царство тьмы - художественный фильм, основанный на одноимённых комиксах издательства Marvel Comics.
1 британский фунт - это примерно 112 российских рублей 50 копеек
Рекрут - шпионский триллер Роджера Доналдсона.
С Земли на Луну - американский научно-фантастический фильм 1958 года.
Мрачные тени - готическая трагикомедия режиссёра Тима Бёртона, являющаяся адаптацией одноимённого телесериала, который показывали на телеканале ABC с 27 июня 1966 года по 2 апреля 1971 года.
Звёздный путь: Вояджер - четвёртый научно-фантастический телесериал на основе вселенной «Звёздный путь», созданный Риком Берманом, Майклом Пиллером и Джери Тейлор.
Я, Робот - художественный научно-фантастический фильм Алекса Пройаса, поставленный по мотивам цикла произведений Айзека Азимова о позитронных роботах.
В главных ролях задействованы Джеффри Раш и Сильвия Хукс.
Уличные танцы 2 - британский и немецкий кинофильм 2012 года.
Вольт - полнометражный компьютерный анимационный фильм 2008 года производства американской студии Walt Disney Animation Studios режиссёров Криса Уильямса и Байрона Ховарда.
Элвин и бурундуки 2 - продолжение фильма «Элвин и бурундуки» режиссёра Бетти Томас.
Футбольный матч Барселона - Атлетик Бильбао завершился со счётом 6 - 0
Выжить После - российский телесериал, повествующий о судьбах людей после зомби-апокалипсиса в мегаполисе, поражённом смертельным вирусом.
Третий фильм из серии Роберта Родригеса «Дети шпионов».
Кирово-Чепецк - город, образующий городской округ, одновременно являющийся административным центром Кирово-Чепецкого муниципального района Кировской области.
Рюриковичи - княжеский, великокняжеский, позднее также царский и королевский род потомков Рюрика, раздробившийся с течением времени на множество ветвей.
Цена' на Золото упала на 0.17 процента, и составила 1099 долларов 60 центов за тройскую унцию
Мишель Мерсье - французская актриса.
Салоники - второй по величине город Греции с населением, вместе с пригородными территориями, более 1 104 460 человек.
Оттепель - российский двенадцатисерийный телесериал режиссёра Валерия Тодоровского, производства киностудии «Мармот-фильм».
Хьюстон - четвёртый по количеству жителей город в Соединённых Штатах Америки и крупнейший город в штате Техас.
Приключения Васи Куролесова - советский рисованный мультипликационный фильм, созданный по одноимённой повести известного писателя Юрия Коваля режиссёром Владимиром Поповым.
1 американский доллар - это примерно 84 российских рубля 20 копеек
Моя прекрасная няня - российский комедийный телесериал производства «Амедиа» и «Sony Pictures», сочетающий в себе элементы ситкома и мелодрамы, снят по мотивам американского сериала «Няня».
Киргизия - государство в Азии. Президент государства - Алмазбек Атамбаев.
Сербский фильм - с натуральным изображением изнасилований, некрофилии и педофилии.
Великобритания - островное государство на северо-западе Европы.
Vodafone - британская компания, один из крупнейших в мире операторов сотовой связи.
Штаб-квартира - в Ньюбери, графство Беркшир.
Майкоп - город в России, столица Республики Адыгея и административный центр городского округа Майкоп.
Наша Russia - российская юмористическая телепередача производства Comedy Club Production, появившаяся на телеканале ТНТ в ноябре 2006 года при участии Павла Воли и Гарика Мартиросяна, известных по юмористической передаче Камеди клаб.
Донал Глисон - ирландский актёр, режиссёр и писатель. В 2006 году был номинирован в премии «Тони» за лучшую мужскую роль в спектакле «Лейтенант с острова Инишмор».
Начало - научно-фантастический триллер Кристофера Нолана, основанный на идее осознанных сновидений.
Суперсемейка - компьютерный анимационный фильм 2004 года студии Pixar, лауреат премии «Оскар», рассказывающий о жизни супергероев.
Чародейки - франко-американский мультипликационный телесериал.
В России премьера сериала состоялась 29 апреля 2005 года на Первом канале.
Люйшунькоу - район городского подчинения города субпровинциального значения Далянь.
Стокгольм - столица и крупнейший город Швеции. Расположен на протоках, соединяющих озеро Меларен с Балтийским морем.
1 квадратный метр - это 0.0001 гектара.
Козерог - десятый знак зодиака, соответствующий сектору эклиптики от 270° до 300°, считая от точки весеннего равноденствия; кардинальный знак тригона Земля.
Пулковская обсерватория - основная астрономическая обсерватория Российской академии наук, располагающаяся в 19 километрах к югу от центра Санкт-Петербурга на Пулковских высотах.
Совместная работа США, Канады и Южной Кореи.
Ульяновск - являвшегося уроженцем Симбирска.
Инд - крупная река в Южной Азии, берёт начало на территории Китая в Гималаях и протекает большей частью по территории северо-западной Индии и Пакистана.
Хоккейный матч Автомобилист - Металлург Мг завершился со счётом 6 - 3
Дневник горничной - фильм французского режиссера Бенуа Жако.
Это третья и наиболее точная из крупных экранизаций одноимённого произведения Октава Мирбо.
Молёбка - село в Кишертском районе Пермского края, с января 2006 года - в составе Осинцевского сельского поселения.
Пятый элемент - фантастический боевик с элементами комедии, снятый французским режиссёром Люком Бессоном в 1996 году на студии «Gaumont».
Враг у ворот - художественный фильм 2001 года.
Глобус - международная сеть гипермаркетов, магазины которой представлены в Германии, Чехии и России.
В России работает под торговой маркой «Глобус».
1 британский фунт - это примерно 112 российских рублей 50 копеек.
Рим - город, столица Италии, административный центр провинции Рим и области Лацио.
Расположен на реке Тибр.
Подземка - французский кинофильм 1985 года.
Подымалово - деревня в Уфимском районе Башкортостана, относится к Дмитриевскому сельсовету.
Angry Birds в кино - предстоящий мультфильм по мотивам популярной игры компании Rovio - Angry Birds.
Гефест - в греческой мифологии бог огня, покровитель кузнечного ремесла и самый искусный кузнец.
Утомлённые солнцем 2: Предстояние - художественный фильм режиссёра Никиты Михалкова.
Является продолжением фильма «Утомлённые солнцем».
Легенда об Искателе - сериал в жанре фэнтези по мотивам произведений Терри Гудкайнда из цикла «Меч Истины», произведённый компанией ABC Studios.
Конвой - художественный фильм Сэма Пекинпа.
Премьера состоялась 28 июня 1978 года.
В СССР показывали в кинотеатрах с дубляжем.
Офшор - финансовый центр, привлекающий иностранный капитал путём предоставления специальных налоговых и других льгот иностранным компаниям, зарегистрированным в стране расположения центра.
Стажёр - американская кинокомедия 2015 года режиссёра Нэнси Мейерс.
Американская история ужасов - американский телесериал-антология в жанре хоррор-триллера, созданный и спродюсированный Райаном Мёрфи и Брэдом Фэлчаком.
Дивергент - американский фильм-антиутопия режиссёра Нила Бёргера, представляющий собой экранизацию романа «Дивергент», написанного Вероникой Рот.
Элвин и бурундуки - семейная комедия о трёх бурундуках, основанная на истории вымышленной музыкальной группы 1960-х и одноимённом американском сериале 1980-х годов.
Самоа - островное государство в южной части Тихого океана, занимающее западную часть одноимённого архипелага.
Люди Икс 2 - супергеройский боевик 2003 года про людей-мутантов по мотивам одноимённого комикса издательства Marvel.
Парк Юрского периода - научно-фантастический фильм 1993 года режиссёра Стивена Спилберга, основанный на одноимённом романе Майкла Крайтона.
Курс акций компании Северсталь вырос на 4.62 процента и составил 661 рубль 20 копеек.
Крещение Господне - событие евангельской истории, крещение Иисуса Христа в реке Иордан Иоанном Крестителем; также христианский праздник, установленный в честь этого события.
Обыкновенное чудо - советский художественный телефильм 1978 года.
Экранизация одноимённой пьесы Евгения Шварца.
Это вторая экранизация пьесы.
Быстрые перемены - художественный фильм, экранизация произведения, автор которого - Джей Кронли.
Ремейк франко-канадского фильма «Ограбление» 1985 года.
1 английский фунт - это примерно 0.454 килограмма.
Интервью с вампиром - мистическая драма и девятый полнометражный фильм ирландского режиссёра и продюсера Нила Джордана, снятый по мотивам одноимённого романа американской писательницы Энн Райс.
Иван Царевич и Серый Волк - российский мультипликационный фильм, который вышел в прокат 29 декабря 2011 года, лидер российского кинопроката 2012 года.
Хижина в лесу - американский триллер.
Абуджа - столица Нигерии с 12 декабря 1991 года.
До этого столицей был город Лагос.
Абуджа расположена в 800 км к северу от прежней столицы.
Второе дыхание - российский фильм 2008 года.
Сумеречные охотники - предстоящий американский фэнтезийный телесериал телеканала ABC Family, основанный на книжной серии «Орудия смерти» писательницы Кассандры Клэр.
Сулия - один из 23 штатов Венесуэлы.
1 американский доллар - это 24.75 украинской гривны.
Бой с тенью - российский кинофильм 2005 года в жанре криминальной драмы режиссёра Алексея Сидорова.
В созвездии Быка - российский кинофильм 2003 года.
Три метра над уровнем неба: Я тебя хочу - испанский фильм режиссёра Фернандо Гонсалеса Молины, снятый по роману Федерико Моччиа «Я хочу тебя».
Билайн - В частности, под этой маркой оказываются услуги сотовой и фиксированной связи, проводного и беспроводного высокоскоростного доступа в Интернет, IP-телевидения.
Сергей Столяров - актёр театра и кино.
Лауреат Сталинской премии первой степени.
Народный артист РСФСР.
Член КПСС с 1958 года.
Лиски - город в России, административный центр Лискинского района Воронежской области и городского поселения Лиски.
Пасха - главное богослужебное событие церковного календаря, древнейший и самый важный христианский праздник, отмечавшийся ещё во времена апостолов и установленный в честь Воскресения Иисуса Христа - центра всей библейской истории и фундамента всего христианского учения.
Гераклит - древнегреческий философ.
Вышел в эфир 25 мая 2013 года.
Стоунхендж - мегалитическое сооружение в графстве Уилтшир, Англия, представляющее собой комплекс кольцевых и подковообразных земляных и каменных конструкций.
Umbrella - вымышленная корпорация, играющая ключевую роль в сюжете серии видеоигр и кинофильмов Resident Evil.
Милые обманщицы - американская телевизионная молодёжная драма, основанная на одноимённой серии романов писательницы Сары Шепард.
Тель-Авив - объединённый городской муниципалитет в Израиле на восточном побережье Средиземного моря, второй в Израиле по численности населения, экономический и культурный центр страны.
Выпущен студией «Союзмультфильм» в 1975 году.
Крайний Север - старейшая газета Чукотского АО.
Издаётся с 28 октября 1933 г.
До 1993 года называлась «Советская Чукотка».
Шарм-эль-Шейх - город-курорт в Египте на южной оконечности Синайского полуострова на побережье Красного моря Египетской ривьеры.
Тарко-Сале - город в Ямало-Ненецком автономном округе России. Административный центр Пуровского района и городского поселения.
Дед Мороз и лето - советский рисованный мультипликационный фильм-сказка о том, как дети познакомили Деда Мороза с летом.
Нострадамус - французский астролог, врач, фармацевт и алхимик, знаменитый своими пророчествами.
Большие гонки - эпическое комедийное роуд-муви американского режиссёра Блэйка Эдвардса.
Улыбка пересмешника - российский шестнадцатисерийный остросюжетный драматический телевизионный художественный фильм режиссёра Алексея Рудакова, снятый в 2014 году.
1 американский доллар - это примерно 84 российских рубля 14 копеек.
Эльвира: Повелительница тьмы - американская кинокомедия.
Гарри Поттер и Орден Феникса - пятый фильм из серии о Гарри Поттере.
ЮНИСЕФ - международная организация, действующая под эгидой Организации Объединённых Наций.
Запретная любовь - художественный фильм Джона Мэйбери 2008 года. Главные роли в нём исполняют Кира Найтли, Сиенна Миллер, Киллиан Мёрфи и Мэттью Рис.
Кавказская пленница, или Новые приключения Шурика - кинофильм Леонида Гайдая, снятый в 1966 году.
Жеребец - американская комедийная драма, премьера которой состоялась 28 июня 2009 года на канале HBO.
1 американский доллар - это примерно 83 российских рубля 59 копеек.
1 белорусский рубль - это примерно 0.00389 российского рубля.
Николай Анатольевич Никифоров - министр связи и массовых коммуникаций Российской Федерации.
Дубровник - город в Хорватии.
Административный центр Дубровницко-Неретванской жупании.
Цена' на нефть марки Brent упала на 1.31 процента, и составила 27 долларов 84 цента за баррель.
Спартак: Кровь и песок - американский исторический телесериал, показ которого начался на кабельном канале Starz с 22 января 2010 года.
Крабат. Ученик колдуна - немецкий кинофильм 2008 года режиссёра Марко Кройцпайнтнера, экранизация одноимённой книги Отфрида Пройслера.
Миньоны - американская анимационная комедия, релиз которой состоялся летом 2015 года.
Российская премьера - 9 июля 2015 года.
Китай - социалистическое (коммунистическое) государство в Восточной Азии.
Accept - немецкая рок-группа, играющая в стиле хэви-метал.
Административный центр муниципального образования город-курорт Пятигорск.
1 американский доллар - это примерно 79 российских рублей 46 копеек.
Коран - священная книга мусульман.
Слово «Коран» происходит от арабского «чтение вслух», «назидание».
Борис Заходер - постсоветский поэт, детский писатель, переводчик, сценарист, популяризатор мировой детской классики.
Мировая премьера состоялась 21 ноября 2008 года.
Джулиан МакМэхон - австралийский актёр.
Хельсингёр - город на северо-восточном побережье датского острова Зеландия.
Всемирно известен как место действия пьесы Вильяма Шекспира «Гамлет, принц датский».
Хабаровск - город в России, административный центр Дальневосточного федерального округа России и Хабаровского края.
1 американский доллар - это 6.58 китайского юаня.
Все ненавидят Криса - американская ситуационная комедия.
Замкнутый круг - кинофильм, драматический триллер режиссёра Лорана Тюэля.
Мировая премьера состоялась 11 марта 2009 года.
Геракл - в древнегреческой мифологии герой, сын бога Зевса и Алкмены - жены героя Амфитриона.
При рождении был назван Алкидом.
Остров ненужных людей - украино-российский художественный телесериал, драма.
Премьера - 19 марта 2012 года на телеканале «Россия 1».
Киргизия - государство в Азии.
Президент государства - Алмазбек Атамбаев.
Сибирский федеральный округ - федеральный округ в сибирской части России.
Пекло - научно-фантастический триллер, вышедший на экраны в апреле 2007 года. Режиссёр фильма - Дэнни Бойл.
Эксперимент 2: Волна - художественный фильм режиссёра Денниса Ганзеля, вышедший на экраны в 2008 году.
1 американский доллар - это примерно 84 российских рубля 98 копеек.
Шоугёлз - кинофильм Пола Верховена о мире шоу-бизнеса.
Сюжет классической ленты «Всё о Еве» перенесён в элитные стрип-клубы Лас-Вегаса.
1 американский доллар - это примерно 84 российских рубля 30 копеек
Годзилла - гигантский монстр-мутант, Кайдзю, персонаж комиксов, мультфильмов и кинофильмов.
Соловьев Сергей Михайлович - русский историк; профессор Московского университета, ректор Московского университета, ординарный академик Императорской Санкт-Петербургской Академии наук по отделению русского языка и словесности, тайный советник.
Семь - психологический триллер Дэвида Финчера с элементами нео-нуара.
Премьера состоялась 25 сентября 1995 года.
Ангелы Чарли - адаптация на большой экран телесериала Ангелы Чарли конца 1970-х годов.
Премьера 1-й и 2-й серий состоялась на канале ТВЦ 14 декабря 2013 года.
Моя любовь - итальянский эротический фильм режиссёра Тинто Брасса.
1 евро - это примерно 87 российских рублей 3 копейки.
Хулиганы - кинофильм.
Костяной томагавк - американский фильм в жанре вестерн с элементами ужасов.
Абаддон - в иудейской теологии - демон истребления, разрушения и смерти.
Трансформеры: Эпоха Истребления - американский фантастический боевик режиссёра Майкла Бэя, четвертый фильм из серии о Трансформерах.
Танцы - телевизионное шоу, стартовавшее на канале ТНТ 23 августа 2014 года.
Шерлок - британский телесериал компании, снятый для.
Кама - крупнейшая река в европейской части России, главная река Западного Урала, символ Пермского края, голубая дорога Прикамья, и важнейшая речная магистраль России.
Первоуральск - административный центр городского округа Первоуральск, город областного подчинения в Свердловской области России, четвёртый по численности населения города в Свердловской области после Екатеринбурга, Нижнего Тагила и Каменска-Уральского.
Безумный Макс: Дорога ярости - постапокалиптический фильм-боевик австралийского режиссёра Джорджа Миллера, четвёртый фильм о Максе Рокатански.
Аэротачки - полнометражный компьютерный мультфильм 2012 года.
Хакасия - республика в составе Российской Федерации, субъект Российской Федерации.
Столица - город Абакан.
Релиз состоялся 14 июня 2005 года.
Первоначально была суперзлодейкой, но позже стала героиней.
Михаил Салтыков-Щедрин - русский писатель, журналист, редактор журнала «Отечественные записки», Рязанский и Тверской вице-губернатор.
Мировая премьера состоялась 27 февраля 2008 года.
Иран - государство в Передней Азии.
Столица - город Тегеран.
Дуглас Энгельбарт - один из первых исследователей человеко-машинного интерфейса и изобретатель компьютерного манипулятора - мыши.
Синдбад: Легенда семи морей - компьютерный анимационный фильм киностудии Dreamworks Pictures.
Кемерово - город в России, административный центр Кемеровской области.
Дудаева Алла - вдова Джохара Дудаева, художник, телеведущая.
Канада - государство в Северной Америке, занимает второе место в мире по площади.
Я плюю на ваши могилы - американский фильм ужасов, триллер 2010 года режиссёра Стивена Монро.
1 американский доллар - это 24.75 украинской гривны
1 сантиметр - это 10 миллиметров.
Тихоокеанский рубеж - американский фантастический боевик 2013 года режиссёра Гильермо дель Торо по сценарию Трэвиса Бичема и дель Торо.
Касл - американский комедийно-драматический телесериал, транслируемый каналом ABC.
Ему приписываются реформы государственного строя и большая строительная деятельность.
Игорь Дмитриевич Сергун - российский военачальник, начальник Главного разведывательного управления Генерального штаба Вооружённых Сил Российской Федерации - заместитель начальника Генерального штаба Вооружённых Сил Российской Федерации, генерал-полковник.
