скачать майнкрафт один точка один точка один точка пять,Ищу ответ [ Открывается поиск по запросу <скачать майнкрафт 1 точка 1 точка 1 точка 5> ],скачать майнкрафт один точка один точка один точка один	search.content.other
секс пожалуйста,Открываю поиск [ Открывается поиск по запросу <секс пожалуйста> ],фильм с волосатой писькой	search.porno.video
скачать игры на айфон пятый,Одну секунду... [ Открывается поиск по запросу <скачать игры на айфон 5> ],скачать shareit на айфон пятый	search.content.other
прямой эфир с малаховым,Давайте поищем [ Открывается поиск по запросу <прямой эфир с малаховым> ],прямой эфир с малаховым от четырнадцатого сентября восемнадцатого года	search.content.video.not_porno
скачать видео бмв эм предмет,Ищу в Яндексе [ Открывается поиск по запросу <скачать видео бмв эм предмет> ],скачать видео бмв пятьсот км до метр набирает триста	search.content.video.not_porno
смотреть хб шоу все серии	search.content.video.not_porno
колобок слушать онлайн	general_conversation.tell.fairytale
слушать аудиокнигу убить оборотня,Открываю поиск [ Открывается поиск по запросу <слушать аудиокнигу убить оборотня> ],слушать аудиокнигу убить оборотня	search.content.audiobooks
значение английского слова велком,Я думаю\, для перевода нет ничего лучше Яндекс.Переводчика.,татьяна полякова аудиокниги слушать бесплатно	search.content.audiobooks
повесть гоголя мертвые души читает вячеслав герасимов	search.content.audiobooks
Поставь сказку от Ивана Охлобыстина	general_conversation.tell.fairytale
включи сказ про федота стрельца	general_conversation.tell.fairytale
хочу закатать штрафы гаи,Ищу ответ [ Открывается поиск по запросу <штрафы гаи> ],яндекс смотреть интересный российский фильм боевик	search.content.film.play
скачать фильм,Открываю. [ Открывается сайт https://kinosimka.net/],скачать мультик ледниковый период	search.content.film.download
мультик маквин,Одну секунду... [ Открывается поиск по запросу <мультик маквин> ],мультик маквин онлайн	search.content.film.play
омерзительная восьмерка	search.content.film.find
покажи сватов на амедиатеке	action.app.video
кто снимался в моей прекрасной няне	search.content.film.info
хочу послушать пение синичек	search.content.nature
включи какой нибудь радио	search.content.radio.fm
алиса включи радио яндекс	search.content.radio.yandex
радио джем фм	search.content.radio.fm
я хотела бы послушать яндекс радио музыку восьмидесятых	search.content.radio.yandex
слушать радио вести фм онлайн	search.content.radio.fm
алиска расскажи мне сказку про трех поросят	general_conversation.tell.fairytale
приключенческий фильм для семейного просмотра,Сейчас найду [ Открывается поиск по запросу <приключенческий фильм для семейного просмотра> ],фильм капитан немо	search.content.film.find
фильм ужасов пираньи все части смотреть онлайн бесплатно	search.content.film.play
привет алиса,Привет.,чужая кровь восьмая серия	search.content.film.find
смотреть мультфильм щенячий патруль,Открываю поиск [ Открывается поиск по запросу <смотреть мультфильм щенячий патруль> ],смотреть мультфильм щенячий патруль	search.content.film.play
кинай полат алемдар перевод русский,Ищу для вас ответ [ Открывается поиск по запросу <кинай полат алемдар перевод русский> ],пулат аландар все фильмы перевод русский	search.content.film.find
аниме где девушка влюбляется в богатого парня,Ищу для вас ответ [ Открывается поиск по запросу <аниме где девушка влюбляется в богатого парня> ],аниме я люблю тебя смотреть онлайн бесплатно все серии	search.content.film.play
видео,Открываю. [ Открывается сайт https://yandex.ru/video/],видео про диану найкову как построить дом из цунами	search.content.video.not_porno
дракула смотреть онлайн,Сейчас найду [ Открывается поиск по запросу <дракула смотреть онлайн> ],дракула 1992 смотреть онлайн	search.content.film.play
слушай алиса,Хеллоу.,молитвы за бобби смотреть онлайн	search.content.film.play
порно  подвижная,Ищу в Яндексе [ Открывается поиск по запросу <порно подвижная> ],порно энергичная	search.porno.video
алиса хочу посмотреть фильм терминатор	search.content.film.play
уральские пельмени,Сейчас найду [ Открывается поиск по запросу <уральские пельмени> ],уральские пельмени все выпуски подряд	search.content.video.not_porno
слушать европа плюс,Включаю подборку "Europa plus".,радио европа плюс коломна слушать онлайн	search.content.radio.fm
фильм пилт,Найдётся всё! [ Открывается поиск по запросу <фильм пилт> ],кино пилт	search.content.film.find
смотри т тридцать четыре онлайн фильм,Уже на загрузку поставила,фильм смотреть тэ тридцать четыре бесплатно онлайн	search.content.film.play
как подключить алису,После скачивания дважды нажмите на сохраненный файл\, Алиса установится мгновенно.,скачать алису яндекс на пк	search.content.other
алиса привет,Хеллоу.,скачать лаборатории касперского	search.content.other
мультик на одной волне порно	search.porno.video
видео с ютуба где задали медведева вопрос школьник о том что его повесят во время революции,Одну секунду... [ Открывается поиск по запросу <видео с ютуба где задали медведева вопрос школьник о том что его повесят во время революции> ],фильм моя гениальная подруга сколько серий	search.content.film.info
алиса покажи видео варшипс,World of Warships [WoWS]. Официальный канал - YouTube www.youtube.com,варшипс бой	search.content.video.not_porno
только ты,Здравствуйте.,мультики	search.content.film.find
какой номер девятый этаж девятый этаж девятый,Найдётся всё! [ Открывается поиск по запросу <какой номер 9 этаж 9 этаж 9> ],скачай мне волшебную палочку	search.content.other
порно видео грузинские телочки,Ищу в Яндексе [ Открывается поиск по запросу <порно видео грузинские телочки> ],порно видео армянские бабы хотят секса	search.porno.video
домашний секс узбекский скрытый камера хороший только узбекский разговор,Открываю поиск [ Открывается поиск по запросу <домашний секс узбекский скрытый камера хороший только узбекский разговор> ],узбекский секс чисто узбекский секс молодежный разговор узбекский	search.porno.video
слушай алиса а включи мне спасение собачек,Ща\, если найду,слушай алиса а ты можешь включить смотрим собачек спасения	search.content.video.not_porno
корпорация монстров два,Ищу для вас ответ [ Открывается поиск по запросу <корпорация монстров 2> ],корпорация монстров все части	search.content.film.find
напиток авива смотреть видео	search.content.video.not_porno
как хочешь,Вы обиделись?,секс длинные сильные	search.porno.video
битва экстрасенсов две тысячи восемнадцатый год,Ищу для вас ответ [ Открывается поиск по запросу <битва экстрасенсов 2018 год> ],битва экстрасенсов девятнадцатый сезон все серии	search.content.video.not_porno
привет алиса маша и медведь сколько серий скажи пожалуйста,78,привет алиса семьдесят восемь пожалуйста включи серию маша и медведь	search.content.film.play
скачать взломанные игры	search.content.other
привет алиса,Я здесь.,один дома бесплатно	search.content.film.find
скачать мультфильм тайна домашних животных,Найдётся всё! [ Открывается поиск по запросу <скачать мультфильм тайна домашних животных> ],турецкий фильм жизнь отдам скачать	search.content.film.download
герои в масках,Открываю поиск [ Открывается поиск по запросу <герои в масках> ],герои в масках	search.content.film.find
привет алиса,Хеллоу.,алиса найди мне клип тяжелый рок металл где инопланетянин в доме там разговаривает с этим человеком	search.content.video.not_porno
кино для детей и взрослых	search.content.film.find
алиса найди мне пожалуйста мультик валли	search.content.film.find
включи мне черепашки ниндзя,Найдётся всё! [ Открывается поиск по запросу <черепашки ниндзя> ],включи мне черепашки ниндзя с нами	search.content.film.play
алиса здравствуйте,Здравствуйте.,а включите мне пожалуйста видеоклипы инна вальтер	search.content.video.not_porno
скачать майнкрафт сто шестнадцать ноль пять,Сейчас найду [ Открывается поиск по запросу <скачать майнкрафт 116 0 5> ],скачать майнкрафт ноль шестнадцать ноль пять	search.content.other
скачать фото дикие кошки,Давайте поищем [ Открывается поиск по запросу <скачать фото дикие кошки> ],скачать дикие человеки	search.content.other
скачать карту для кс один и шесть на андроид,Сейчас найду [ Открывается поиск по запросу <скачать карту для кс 1 и 6 на андроид> ],скачать карту для кс один и шесть со нычками	search.content.other
песня поли робокар,Ищу для вас ответ [ Открывается поиск по запросу <песня поли робокар> ],мультик поли робокар	search.content.film.find
секс внука с бабушкой,Одну секунду... [ Открывается поиск по запросу <секс внука с бабушкой> ],секс внука с бабушкой	search.porno.video
секс китайский,Давайте поищем [ Открывается поиск по запросу <секс китайский> ],афганский секс	search.porno.video
алиса покажи мне видео как разобрать поршневую на мотоцикле урал,Найдётся всё! [ Открывается поиск по запросу <видео как разобрать поршневую на мотоцикле урал> ],алиса покажи мне как разобрать поршневую на мотоцикле урал видео	search.content.video.not_porno
посмотреть видео бабы за рулем,Сейчас найдём [ Открывается поиск по запросу <посмотреть видео бабы за рулем> ],любовь по взрослому	search.content.film.find
алиса посоветуй фильм,Посмотрите в спорте только девушки,найди в интернете описание фильма в спорте только девушки	search.content.film.info
фильм папа,Найдётся всё! [ Открывается поиск по запросу <фильм папа> ],фильм папа автоботы	search.content.film.find
порно с поцелуями,Сейчас найдём [ Открывается поиск по запросу <порно с поцелуями> ],порно с поцелуями	search.porno.video
смотреть майнкрафт профессионалы нубик,Сейчас найдём [ Открывается поиск по запросу <смотреть майнкрафт профессионалы нубик> ],смотреть майнкрафт профессионал и нубик	search.content.video.not_porno
свежие новые песни даргинские пазилат омаровой на гармошках,Сейчас найду [ Открывается поиск по запросу <свежие новые песни даргинские пазилат омаровой на гармошках> ],красивые зимние картинки скачать	search.content.other
привет,Я здесь.,пожалуйста найди в лаунчер майнкрафт	search.content.other
американский секс,Ищу в Яндексе [ Открывается поиск по запросу <американский секс> ],американский рэпер клип фифти сент пятьдесят	search.content.video.not_porno
скачать пульт на телевизор lg,Одну секунду... [ Открывается поиск по запросу <скачать пульт на телевизор lg> ],скачать пульт на телевизор lg	search.content.other
телефильмы,Сейчас найду [ Открывается поиск по запросу <телефильмы> ],сумерки	search.content.film.find
алиса порно,Одну секунду... [ Открывается поиск по запросу <порно> ],порно видео поймали диверсантку	search.porno.video
как ебутся богатые русские,Найдётся всё! [ Открывается поиск по запросу <как ебутся богатые русские> ],новое порно видео елены берковой	search.porno.video
привет хочу посмотреть на гей секс	search.porno.video
ееротика,Звучит как заклинание,еротика	search.porno.video
радиостанция нара фм,Открываю подборку "Сегодня на радио: хиты FM".,нара фм	search.content.radio.fm
покажи мне прикольное видео про котиков	search.content.video.not_porno
привет алиса,Я здесь.,включи мультик шарики	search.content.film.play
охота на медведя с ножом не для слабонервных,Давайте поищем [ Открывается поиск по запросу <охота на медведя с ножом не для слабонервных> ],охота на медведя с ножом без цензуры	search.content.video.not_porno
женщина bloody b диалоги,Открываю поиск [ Открывается поиск по запросу <женщина bloody b диалоги> ],культуристы женщины порно	search.porno.video
порно с неграми	search.porno.video
привет,Здравствуйте.,алиса можно посмотреть девочке какой то мультик большие	search.content.film.play
скачать открытку бесплатно спасибо,Сейчас найдём [ Открывается поиск по запросу <скачать открытку бесплатно спасибо> ],скачать открытку бесплатно благодарю	search.content.other
порно с животными,Сейчас найдём [ Открывается поиск по запросу <порно с животными> ],порно трансов веб камера	search.porno.video
алиса ты ебанутая что ли включи нахуй гриффинов мультик детям бегом,Включаю: Большой детский хор Всесоюзного радио и Центрального телевидения\, Сергей Парамонов\, альбом "Песни из мультфильмов"\, песня "Песенка крокодила Гены (Пусть бегут неуклюже…)".,алиса включи мультик гринч онлайн бесплатно	search.content.film.play
говори,Я не знаю\, с чего начать,щенячий патруль	search.content.film.find
советские фильмы про революцию,Одну секунду... [ Открывается поиск по запросу <советские фильмы про революцию> ],любовь и голуби фильм 1984	search.content.film.find
кто такой маршал,Ма́ршал (нем. Marschall < др.-в.-нем. marahscalc «конюх») — воинское звание (или чин) высшего генеральского состава в армиях ряда государств. В некоторых государствах (дореволюционная Россия\, Великобритания\, Германия\, Австрия...,смотреть голос	search.content.video.not_porno
алиса позвонить анюта,Пока что я умею звонить только в экстренные службы.,алиса смотреть айкарли не по яндексу	search.content.film.play
выебал волосатую пизду,Ищу в Яндексе [ Открывается поиск по запросу <выебал волосатую пизду> ],выебала	search.porno.video
скачать майнкрафт,Ищу ответ [ Открывается поиск по запросу <скачать майнкрафт> ],скачать майнкрафт	search.content.other
универ третий сезон,Сейчас найду [ Открывается поиск по запросу <универ 3 сезон> ],универ старая общага третий сезон тридцатая серия	search.content.film.find
фильмы две тысячи восемнадцатого года,Одну секунду... [ Открывается поиск по запросу <фильмы 2018 года> ],веном фильм 2018	search.content.film.find
покажи секс,Сейчас найдём [ Открывается поиск по запросу <секс> ],алиса в хорошем качестве фильм империя акул с хорошей озвучкой	search.content.film.find
скрытые наса смотреть фильм,Давайте поищем [ Открывается поиск по запросу <скрытые наса смотреть фильм> ],скрытые фигуры смотреть онлайн	search.content.film.play
порно русской бабушки кряхтит	search.porno.video
тюрьмы пожизненные в азербайджане видео,Давайте поищем [ Открывается поиск по запросу <тюрьмы пожизненные в азербайджане видео> ],самые страшные тюрьмы в азербайджане видео	search.content.video.not_porno
великий из бродячих псов секс,Одну секунду... [ Открывается поиск по запросу <великий из бродячих псов секс> ],секс	search.porno.video
александр барыкин,Открываю: Александр Барыкин.,смотреть битву экстрасенсов девятнадцатый сезон	search.content.video.not_porno
алиса включи звуки леса	search.content.nature
пожалуйста,Вы просите или благодарите?,лунтик	search.content.film.find
порно молодые девчонки,Ищу ответ [ Открывается поиск по запросу <порно молодые девчонки> ],порно молодые девчонки	search.porno.video
скачать новую версию симса	search.content.other
скачать песню,Открываю вашу радиостанцию.,скачать игру shadow fight два взломанную	search.content.other
горячая девушка китайский на русском языке,Погодите. Эта фраза уже на русском.,горячая девушка китайский кино на русском озвучке	search.content.film.find
привет,Привет.,девочка вампир 107 серищ	search.content.film.find
откровенный домашний секс,Одну секунду... [ Открывается поиск по запросу <откровенный домашний секс> ],откровенные ласковый секс	search.porno.video
русское порно подрочила и отсосала у собаки	search.porno.video
фильм бомжиха,Открываю поиск [ Открывается поиск по запросу <фильм бомжиха> ],фильм бомж	search.content.film.find
алиса найди фильм полицейский с рублевки новогодний беспредел,Одну секунду... [ Открывается поиск по запросу <фильм полицейский с рублевки новогодний беспредел> ],алиса найди фильм полицейский с рублевки смотреть онлайн без регистрации	search.content.film.play
слушай алиса давай посмотрим дом два	search.content.video.not_porno
алиса слушай,Хеллоу.,мультики	search.content.film.find
привет,Я здесь.,скачать настройщик для гитары	search.content.other
фото петрова из фильма петров и васечкин,Давайте поищем [ Открывается поиск по запросу <фото петрова из фильма петров и васечкин> ],кто сыграл в фильме приключения петрова и васечкина васечкина	search.content.film.info
русский восемнадцать кров,Ищу ответ [ Открывается поиск по запросу <русский 18 кров> ],русский секс восемнадцать лет	search.porno.video
механическое порно дилдо,Найдётся всё! [ Открывается поиск по запросу <механическое порно дилдо> ],механическое порно дилдо	search.porno.video
алиса набери песню деспасито,Открываю: Luis Fonsi\, Daddy Yankee\, альбом "Despacito".,алиса набери видео деспасито	search.content.video.not_porno
фильм полуночный человек скачать онлайн бесплатно,Ищу в Яндексе [ Открывается поиск по запросу <фильм полуночный человек скачать онлайн бесплатно> ],фильм полуночный человек скачать на телефон бесплатно	search.content.film.download
больница дрочит видео,Ищу ответ [ Открывается поиск по запросу <больница дрочит видео> ],дрочит видео	search.porno.video
смотреть фильм любовь три д,Давайте поищем [ Открывается поиск по запросу <смотреть фильм любовь 3 д> ],смотреть фильм любовь три д в хорошем качестве	search.content.film.play
ходячие мертвецы википедия сколько серий в последнем сезоне,Ищу в Яндексе [ Открывается поиск по запросу <ходячие мертвецы википедия сколько серий в последнем сезоне> ],проповедник иностранный сериал	search.content.film.find
как включить игру кирби,Одну секунду... [ Открывается поиск по запросу <как включить игру кирби> ],как скачать игру кирби	search.content.other
корейский секс порно кино	search.porno.video
смешные видео секса,Ищу ответ [ Открывается поиск по запросу <смешные видео секса> ],секс видео	search.porno.video
алиса смотреть онлайн художник фильм супер бобровы,Давайте поищем [ Открывается поиск по запросу <смотреть онлайн художник фильм супер бобровы> ],смотреть художественный фильм супербобровы два	search.content.film.play
окей гугл мистер макс и мисс кейти видео,Открываю поиск [ Открывается поиск по запросу <мистер макс и мисс кейти видео> ],окей гугл мистер макс и мисс кейти	search.content.video.not_porno
игры для девочек,Одну секунду... [ Открывается поиск по запросу <игры для девочек> ],видео для девочек	search.content.video.not_porno
езидский,Открываю поиск [ Открывается поиск по запросу <езидский> ],езидский клипы	search.content.video.not_porno
умизуми одиннадцатая серия,Хороший сериал?,умизуми одиннадцатая серия	search.content.film.find
алиса ты что спишь,Я никогда не сплю. Просто глаза прикрыла на минутку. Шутка.,покажи как целку открывает	search.porno.video
скачать зону,Открываю поиск [ Открывается поиск по запросу <скачать зону> ],скачать the nun	search.content.other
премьеры фильмов в кинотеатр город железногорск курской области в руси,Сейчас найду [ Открывается поиск по запросу <премьеры фильмов в кинотеатр город железногорск курской области в руси> ],американское шоу голос поет негр песню крейзи	search.content.video.not_porno
голос перезагрузка как поет военные видео,Сейчас найду [ Открывается поиск по запросу <голос перезагрузка как поет военные видео> ],показать песню стап пипл видео	search.content.video.not_porno
мультик про николу,Ищу в Яндексе [ Открывается поиск по запросу <мультик про николу> ],мультик как мама капуки кануки	search.content.film.find
какая дичь это мягко сказано,Это вы сейчас к чему?,о чем фильм антихрист две тысячи девятого года посвященный андрею тарковскому	search.content.film.info
легенда о чу сяо,Найдётся всё! [ Открывается поиск по запросу <легенда о чу сяо> ],легенда о чу сяо 2 сезон	search.content.film.find
порно толстых красивых,Найдётся всё! [ Открывается поиск по запросу <порно толстых красивых> ],порно	search.porno.video
скачать любые взломанные игры,Ищу ответ [ Открывается поиск по запросу <скачать любые взломанные игры> ],скачать мортал комбат x взломанную	search.content.other
алиса открой мне рекламу на ютубе,Реклама — Википедия ru.wikipedia.org,алиса открой мне рекламу на ютубе со звонком	action.app.video
ютуб детям,Кукутики - Сборник. Десять песенок для малышей www.youtube.com,ютуб детям	action.app.video
открой ютуб,"YouTube" — видеохоcтинг youtube.com,найди про трактор мтз восемьдесят на ютубе	action.app.video
ютуб,"YouTube" — видеохоcтинг m.youtube.com,ютуб infinity evolved сборка	action.app.video
порно мамочек,Сейчас найду [ Открывается поиск по запросу <порно мамочек> ],порно изнасилование мамочек бутылками	search.porno.video
кагда начинает шевелитца ребенак седьмые роды видео гинеколога,Ищу для вас ответ [ Открывается поиск по запросу <когда начинает шевелиться ребенок 7 роды видео гинеколога> ],начинает ребенок шевелят шестнадцать семнадцать недель седьмой роды видео	search.content.video.not_porno
клип я украду,Открываю поиск [ Открывается поиск по запросу <клип я украду> ],клип я не женюсь	search.content.video.not_porno
алиса в какой серии сериала ривердейл баклан и бетти первый раз поцеловались,Сейчас найду [ Открывается поиск по запросу <в какой серии сериала ривердейл баклан и бетти 1 раз поцеловались> ],ривердейл первый сезон первая серия	search.content.film.find
россия,Сейчас найду [ Открывается поиск по запросу <россия> ],мультик хороший	search.content.film.find
слушай алиса включи мультики,Ладушки\, уже включаю,включи мультики	search.content.film.play
бородина против бузовой где делали днк эту серию смотреть,Сейчас найду [ Открывается поиск по запросу <бородина против бузовой где делали днк эту серию смотреть> ],днк последние выпуски	search.content.video.not_porno
катя и макс мультики для детей,Одну секунду... [ Открывается поиск по запросу <катя и макс мультики для детей> ],совместный танец мамы с двумя дочками	search.content.video.not_porno
скачать тихий дон аудиокнигу mp четыре,Сейчас найду [ Открывается поиск по запросу <скачать тихий дон аудиокнигу mp 4> ],скачать книгу аудиокнигу тихий дон м четыре полностью	search.content.audiobooks
алиса смотреть,На что смотреть-то?,алиса смотреть тарас бульба	search.content.film.play
алиса можешь включить мультик гравити фолз,Уже поставила на загрузку,алиса можешь включить мультик гравити фолз	search.content.film.play
сколько лет героям персонажи,Ищу для вас ответ [ Открывается поиск по запросу <сколько лет героям персонажи> ],сколько лет актерам из сериала воронины	search.content.film.info
алиса порно,Ищу в Яндексе [ Открывается поиск по запросу <порно> ],алис найди мне фильм дэдпул два	search.content.film.find
алиса скачать программу для которая вставляет музыку видеоклипы,Ищу для вас ответ [ Открывается поиск по запросу <скачать программу для которая вставляет музыку видеоклипы> ],скачать бесплатно программу на пк для вставки музыки видеоклипы	search.content.other
алиса детская игра,Ищу ответ [ Открывается поиск по запросу <детская игра> ],алиса мультик то есть	search.content.film.find
точно,Сейчас все будет,смотреть майнкрафт	search.content.video.not_porno
алиса покажи мне мультик боты спасатели третий сезон без дедушек,Ищу в Яндексе [ Открывается поиск по запросу <мультик боты спасатели 3 сезон без дедушек> ],алиса боты спасатели четвертый сезон без дедушек	search.content.film.find
смотреть,А что смотреть-то?,орудие смерти город костей смотреть	search.content.film.play
название фильма где парень заступился за девушку которая унижает	search.content.film.info
желейный медведь валера опыты,ЖЕЛЕЙНЫЙ МЕДВЕДЬ ВАЛЕРА И АНТИСТРЕСС - Продолжительность: 5:09 Познаватель 31 056 480 просмотров.,опыты видео	search.content.video.not_porno
интервью ахеджаковой собчак,Собчак Ксения Анатольевна — Российский политик\, теле- и радиоведущая\, журналистка\, общественный деятель\, актриса. Член политсовета партии «Партия перемен» с 23 декабря 2017 года. Известна по реалити-шоу «Дом-2»\, «Блондинка в шоколаде»\, «Последний герой»\, а также передачам «Госдеп 2» и «Собчак живьём»\, вела программу «Барабака и Серый Волк» вместе с Сергеем Кальварским на радиостанции «Серебряный дождь».,смотреть интервью ахеджаковой которая дала на собчак	search.content.video.not_porno
русское порно,Одну секунду... [ Открывается поиск по запросу <русское порно> ],красивые с молоденькими девочками русское	search.porno.video
мультик самоцветов для детей,Открываю поиск [ Открывается поиск по запросу <мультик самоцветов для детей> ],гора самоцветов мультфильм для детей	search.content.film.find
каляев двадцать пятое января сегодня,Сегодня в Кувандыке суббота\, 26 января 2019 года,камеди клаб двадцать пятое января две тысячи девятнадцать	search.content.video.not_porno
дискотека восемьдесят,Найдётся всё! [ Открывается поиск по запросу <дискотека 80> ],авторадио	search.content.radio.fm
корейский сериал мистический,Одну секунду... [ Открывается поиск по запросу <корейский сериал мистический> ],корейский сериал миссис хаммурапи	search.content.film.find
где находится торонто,Торонто (Toronto) – крупнейший город и важный экономический центр Канады. Это также один из ведущих мегаполисов мира и самый процветающий город страны,папины дочки сериал	search.content.film.find
большое ухо мультик,Ищу для вас ответ [ Открывается поиск по запросу <большое ухо мультик> ],мультик большой ух	search.content.film.find
свадьба,Ищу ответ [ Открывается поиск по запросу <свадьба> ],ну погоди	search.content.film.find
катастрофа самолета ту двадцать два м,Открываю поиск [ Открывается поиск по запросу <катастрофа самолета ту 22 м> ],видео катастрофы самолета ту двадцать два m под мурманском	search.content.video.not_porno
смотреть фильмы онлайн,Сейчас найдём [ Открывается поиск по запросу <смотреть фильмы онлайн> ],смотреть фильмы онлайн молчание ягнят	search.content.film.play
включи черепашки ниндзя,Ни приложения такого\, ни сайта мне найти не удалось. Но\, может быть\, в другой раз получится.,черепашки ниндзя смотреть онлайн	search.content.film.play
эртугрул сто тридцать три тридцать,Ищу в Яндексе [ Открывается поиск по запросу <эртугрул 133 30> ],эртугрул сто тридцать третья серия	search.content.film.find
шишонин гимнастика для шеи видео скачать	search.content.video.not_porno
световой дождь для участка,Ищу ответ [ Открывается поиск по запросу <световой дождь для участка> ],световой дождь для участка видео	search.content.video.not_porno
алиса что подарить тете которую зовут вика,Давайте поищем [ Открывается поиск по запросу <что подарить тете которую зовут вика> ],сексь	search.porno.video
мультики про всех принцесс,Найдётся всё! [ Открывается поиск по запросу <мультики про всех принцесс> ],мультики принцессы для девочек	search.content.film.find
онлайн бесплатно смотреть майнкрафт с евгеном бро и вайнрана и алисы,Ищу в Яндексе [ Открывается поиск по запросу <онлайн бесплатно смотреть майнкрафт с евгеном бро и вайнрана и алисы> ],онлайн бесплатно смотреть майнкрафт с турбо ежиком и с кем нибудь	search.content.video.not_porno
мне нужно алиса,Что именно вам нужно?,а фильм можно это эротический какой нибудь	search.porno.video
арсенал манчестер юнайтед прямая трансляция,Одну секунду... [ Открывается поиск по запросу <арсенал манчестер юнайтед прямая трансляция> ],арсенал манчестер юнайтед прямая трансляция	search.content.video.not_porno
слушай алиса скачать кем приносит этот фредди на андроид бесплатно,Давайте поищем [ Открывается поиск по запросу <скачать кем приносит этот фредди на андроид бесплатно> ],слушай алиса скачать файф найт ит крепи найт энд фредди бесплатно	search.content.other
хорошо,Ну\, смотрите мне\, я слежу за вами,пожалуйста алиса мультики для маленьких	search.content.film.find
радио дагестан,Открываю: Ханчик\, альбом \"Нежная\"\, песня \"Дагестан\".,радио музыки	search.content.radio.fm
что,Что?,алиса секс элька	search.porno.video
мистер макс плей майнкрафт	search.content.video.not_porno
самый лучший фильм,Найдётся всё! [ Открывается поиск по запросу <самый лучший фильм> ],смотреть самый лучший фильм	search.content.film.play
видео парень уговорил сестру за деньги,Открываю поиск [ Открывается поиск по запросу <видео парень уговорил сестру за деньги> ],видео парень уговорил сестру за деньги дать ему	search.porno.video
алиса,Привет-привет!,в каком году появился фильм офицеры	search.content.film.info
звездные,Открываю поиск [ Открывается поиск по запросу <звездные> ],молодой втроем	search.porno.video
посмотреть мультфильмы детские	search.content.film.play
клип мановар,Ищу ответ [ Открывается поиск по запросу <клип мановар> ],про трактористов клип покажи	search.content.video.not_porno
покажи нам как животные разговаривают приколы,Ищу ответ [ Открывается поиск по запросу <как животные разговаривают приколы> ],приколы как разговаривают животные	search.content.video.not_porno
кхл,Сейчас найду [ Открывается поиск по запросу <кхл> ],салават юлаев барыс онлайн смотреть	search.content.video.not_porno
канун который колит в обе стороны,Ищу ответ [ Открывается поиск по запросу <канун который колит в обе стороны> ],покажи колун который колят в обе стороны видео	search.content.video.not_porno
иркутск,Давайте поищем [ Открывается поиск по запросу <иркутск> ],кунилингус	search.porno.video
фильмы новинки две тысячи восемнадцатого года смотреть онлайн в хорошем качестве,Давайте поищем [ Открывается поиск по запросу <фильмы новинки 2018 года смотреть онлайн в хорошем качестве> ],полицейский с рублевки сериал четвертый сезон	search.content.film.find
порно старых дам	search.porno.video
смотреть,Но сначала выглянуть,семейные фильмы	search.content.film.find
смертельная битва один,Сейчас найду [ Открывается поиск по запросу <смертельная битва 1> ],смертельная битва один	search.content.film.find
девушка транс эротика,Открываю поиск [ Открывается поиск по запросу <девушка транс эротика> ],слушай трансом эротика на русском языке	search.porno.video
скачать взломанную игру крейзи на ввв андроид точка ру,Открываю поиск [ Открывается поиск по запросу <скачать взломанную игру крейзи на ввв андроид точка ру> ],скачать взломанную игру kitchens	search.content.other
интернет есть,Есть\, но я им не пользуюсь,сериал внутри тридцатая серия	search.content.film.find
художественный фильм механик,Найдётся всё! [ Открывается поиск по запросу <художественный фильм механик> ],художественный фильм машинист	search.content.film.find
страшная смерть,Ищу в Яндексе [ Открывается поиск по запросу <страшная смерть> ],самоубийство видео	search.content.video.not_porno
смотреть ам ням,Давайте поищем [ Открывается поиск по запросу <смотреть ам ням> ],смотреть мультфильм амням	search.content.film.play
привет,Здравствуйте.,сэкс 	search.porno.video
секс с животными,Сейчас найду [ Открывается поиск по запросу <секс с животными> ],секс с животными	search.porno.video
алиса пожалуйста дай мне в uvp картинку,Ищу для вас ответ [ Открывается поиск по запросу <в uvp картинку> ],алиса дай мне картинку аву п	search.content.other
секс с молодыми телочками девушками,Ищу в Яндексе [ Открывается поиск по запросу <секс с молодыми телочками девушками> ],секс с молодыми телочками	search.porno.video
детский мир как строили,Давайте поищем [ Открывается поиск по запросу <детский мир как строили> ],видео про детский мир который строили	search.content.video.not_porno
босс молокосос,Давайте поищем [ Открывается поиск по запросу <босс молокосос> ],босс молокосос	search.content.film.find
зеленый и черепаха,Открываю поиск [ Открывается поиск по запросу <зеленый и черепаха> ],ягненок и черепаха смотреть	search.content.film.play
алис покажи фотографии хомяков,Сейчас найду [ Открывается поиск по запросу <фотографии хомяков> ],алиса фотографии медведей	search.content.other
что еще,Тебе все перечислять?,в лесу родилась елочка песня видео	search.content.video.not_porno
алиса спой песенку пожалуйста,Стихи автопоэта\, музыка нейронная. Исполняет Алиса.,алиса алиса мультик мы делили апельсин	search.content.film.find
песня про папу,Открываю поиск [ Открывается поиск по запросу <песня про папу> ],включи ка пука мультик	search.content.film.play
скачать игру диабло,Найдётся всё! [ Открывается поиск по запросу <скачать игру диабло> ],скачать игру через торрент фнаф шесть	search.content.other
у нас делают пиццу,Ищу для вас ответ [ Открывается поиск по запросу <у нас делают пиццу> ],вселенная стивена пятый сезон	search.content.film.find
смотреть бесплатно знак стон,Открываю поиск [ Открывается поиск по запросу <смотреть бесплатно знак стон> ],смотреть бесплатно зак шторм	search.content.film.play
хрусталь фильм,Давайте поищем [ Открывается поиск по запросу <хрусталь фильм> ],кто сыграл главную роль в фильме хрусталь	search.content.film.info
порно дама	search.porno.video
привет алиса,Хеллоу.,фильм порно смотреть онлайн	search.porno.video
один плюс один,2,фильм один плюс один	search.content.film.find
мне пожалуйста,Ну\, раз вы просите...,ебля	search.porno.video
покажи как симсаны занимаются сексом,Открываю поиск [ Открывается поиск по запросу <как симпсоны занимаются сексом> ],покажи как симсими дети трахаются	search.porno.video
видео о вреде шоколадных яиц киндер,Давайте поищем [ Открывается поиск по запросу <видео о вреде шоколадных яиц киндер> ],видео о вреде чипсов	search.content.video.not_porno
алиса включи пожалуйста мультик роблокс,Давайте поищем [ Открывается поиск по запросу <мультик роблокс> ],алиса пожалуйста включи мультик роблокс майнкрафт	search.content.film.play
